MUSICSKINS	musicskins.com
MUSICTODAY	musictoday.com
MUSICUNION	musicunion.com
MUSIGRAM	musigram.com
MUSIKIDS	musikids.com
MUSIO	musio.com
MUSIQTONE	musiqtone.com
MUSISTIC	musistic.com
MUSOCRAT	musocrat.com
MUSSELBOUND	musselbound.com
MUSTERED	mustered.com
MUSYNC	musync.com
MUTADO	mutado.com
MUTEXSYSTEMS	mutexsystems.com
MUTINY	mutiny.com
MUTTROPOLIS	muttropolis.com
MUTTVILLE	muttville.org
MUTTYWARE	muttyware.com
MUTUALART	mutualart.com
MUTUALINK	mutualink.net
MUTUALMIND	mutualmind.com
MUW	muw.edu
MUWOM	muwom.com
MUZAK	muzak.com
MUZE	muze.com
MUZEION	muzeion.com
MUZEO	muzeo.org
MUZEVIEW	muzeview.com
MUZMEE	muzmee.com
MVCC	mvcc.net
MVCF	mvcf.com
MVCTC	mvctc.com
MVFS	mvfs.com
MVISOLUTIONS	mvisolutions.com
MVLP	mvlp.net
MVMDATA	mvmdata.com
MVP2SCALE	mvp2scale.com
MVRDV	mvrdv.com
MVTRAC	mvtrac.com
MVUC	mvuc.org
MWAA	mwaa.com
MWCIA	mwcia.org
MWCOG	mwcog.org
MWE	mwe.com
MWELA	mwela.net
MWI	mwi.com
MWI	mwi.org
MWMCA	mwmca.org
MWRD	mwrd.org
TKLF	tklf.org
TKMAXX	tkmaxx.com
TKOART	tkoart.com
TKRG	tkrg.com
TKWEB	tkweb.com
TKYGROUP	tkygroup.net
TLAE	tlae.net
TLC-EXPO	tlc-expo.com
TLC4SUPERTEAMS	tlc4superteams.com
TLCONCEPTS	tlconcepts.net
TLCVISION	tlcvision.com
TLDRLEGAL	tldrlegal.com
TLDSTUDIO	tldstudio.com
TLEEDESIGN	tleedesign.com
TLEHS	tlehs.com
TLG7	tlg7.com
TLGC	tlgc.com
TLIC	tlic.com
TLKMULTIMEDIA	tlkmultimedia.com
TLSI	tlsi.com
TM1PRO	tm1pro.com
TMAC	tmac.org
TMAIT	tmait.org
TMARKSDESIGN	tmarksdesign.com
TMB	tmb.com
TMBA	tmba.com
TMBPARTNERS	tmbpartners.com
TMCCG	tmccg.com
TMLP	tmlp.com
TMLT	tmlt.org
TMMC	tmmc.com
TMMDATA	tmmdata.com
TMNCORP	tmncorp.com
TMONE	tmone.com
TMPG	tmpg.com
TMRS	tmrs.com
TMS	tms.org
TMWEBER	tmweber.com
TNBANK	tnbank.net
TNC	tnc.org
TNDRBOX	tndrbox.net
TNFX	tnfx.com
TNGRAFIX	tngrafix.com
TNI	tni.com
TNMP	tnmp.com
TNSI	tnsi.com
TNT	tnt.com
TNTP	tntp.org
TOASTERBOT	toasterbot.com
TOASTINGDESIGN	toastingdesign.com
TOBI	tobi.com
TOBINCONNEX	tobinconnex.com
TOBINWORLD	tobinworld.org
TOCA	toca.com
TOCAGEN	tocagen.com
TOCCA	tocca.com
TOCCS	toccs.com
TOCMEDIA	tocmedia.com
TOCQUIGNY	tocquigny.com
TODA	toda.net
THEBCO	thebco.com
THEBEALINE	thebealine.com
THEBIGFORK	thebigfork.com
THEBIGSPACE	thebigspace.com
THEBIGWORD	thebigword.com
THEBIGZOO	thebigzoo.com
THEBIOTECHPANEL	thebiotechpanel.com
THEBIZDEN	thebizden.org
THEBOARDTV	theboardtv.com
THEBOLLINGERS	thebollingers.net
THEBRIDEORGANIZER	thebrideorganizer.com
THEBROKERLIST	thebrokerlist.com
THEBTO	thebto.com
THECALILIFE	thecalilife.com
THECALL	thecall.com
THECFO2GO	thecfo2go.com
THECITYMOMS	thecitymoms.org
THECOLLECTIVESHIFT	thecollectiveshift.com
THECOMMSAPP	thecommsapp.com
THECONDOHUB	thecondohub.com
THECOURSEFORUM	thecourseforum.com
THECUSTOMBOXES	thecustomboxes.com
THEDACARE	thedacare.org
THEDATABANK	thedatabank.com
THEDREAMVINE	thedreamvine.com
THEDRIVERSLAB	thedriverslab.com
THEEDGECONSTRUCTIONCO	theedgeconstructionco.com
THEERY	theery.com
THEEYEWORKS	theeyeworks.com
THEFAMOUSGROUP	thefamousgroup.com
THEFASTNET	thefastnet.net
THEFINDLINGGROUP	thefindlinggroup.com
THEFRAMEWORKS	theframeworks.com
THEGAMERSBLOG	thegamersblog.com
THEGKWCO	thegkwco.com
THEGREATUS	thegreatus.com
THEGREEKSPACE	thegreekspace.com
THEGREENSHEET	thegreensheet.com
THEGRENWOODS	thegrenwoods.com
THEHOMEMAG	thehomemag.com
THEINDIANIMPACT	theindianimpact.com
THEINFOPEOPLE	theinfopeople.com
THEINWORLD	theinworld.com
THEISPSTORE	theispstore.com
THEIWLA	theiwla.com
THEJ3CORPORATION	thej3corporation.com
THEJACKSFIRM	thejacksfirm.com
THEJOBWORK	thejobwork.com
THEKEY2FREE	thekey2free.org
THELADDERS	theladders.com
THELIFT	thelift.net
THELIONS	thelions.com
THELIQUIDBETSY	theliquidbetsy.com
THELIVELINE	theliveline.com
THEMADGEEK	themadgeek.com
THEMAKEUPGIRL	themakeupgirl.net
THEMARKETPRO	themarketpro.net
THEMATIX	thematix.com
THEMEDIACREW	themediacrew.com
THEMENDOUS	themendous.com
THEMEPARK	themepark.com
THEMIGROUP	themigroup.com
THEMIS	themis.com
THEMOBILEYOGI	themobileyogi.com
THEMODERNTRUNK	themoderntrunk.com
THEMODULARWAY	themodularway.com
THEMONEYEVENT	themoneyevent.com
THEMOV	themov.org
THEMURPHSHOW	themurphshow.com
THENAVIGATORGROUP	thenavigatorgroup.com
THENEEDS	theneeds.com
THENETLAB	thenetlab.com
THENEWBLANK	thenewblank.com
THENEWSMARKET	thenewsmarket.com
THENEXTWORD	thenextword.com
THENORTHGATE	thenorthgate.org
SULPHCO	sulphco.com
SULTRA	sultra.com
SULVO	sulvo.com
SULZER	sulzer.com
SUMAGREEN	sumagreen.com
SUMALL	sumall.com
SUMAZI	sumazi.com
SUMBRIDGE	sumbridge.com
SUMEQUAL	sumequal.com
SUMER	sumer.com
SUMERIAN	sumerian.com
SUMIX	sumix.com
SUMMACARE	summacare.com
SUMMERCRAFTS	summercrafts.org
SUMMERFUEL	summerfuel.com
SUMMERIPE	summeripe.com
SUMMERMAINE	summermaine.com
SUMMERNATION	summernation.com
SUMMERWOOD	summerwood.biz
SUMMITAS	summitas.com
SUMMITCONTRACTING	summitcontracting.net
SUMMITHEALTH	summithealth.org
SUMMITIG	summitig.com
SUMMITTECHCONSULTING	summittechconsulting.com
SUMMON	summon.com
SUMMUM	summum.org
SUMOING	sumoing.com
SUMPOSITIVE	sumpositive.com
SUMPURA	sumpura.com
SUMTIO	sumtio.com
SUN-SENTINEL	sun-sentinel.com
SUN	sun.com
SUNAMERICA	sunamerica.com
SUNBELTNISSAN	sunbeltnissan.com
SUNBORNE	sunborne.com
SUNBOUND	sunbound.com
SUNBROTHERS	sunbrothers.com
SUNCADIA	suncadia.com
SUNCAL	suncal.com
SUNCAPSULE	suncapsule.com
SUNCHILLER	sunchiller.com
SUNDARI	sundari.com
SUNDAYSKY	sundaysky.com
SUNDBERGDESIGN	sundbergdesign.com
SUNDEK	sundek.com
SUNDITA	sundita.com
SUNDOOR	sundoor.com
SUNDRYDROP	sundrydrop.com
SUNDYNE	sundyne.com
SUNEDISON	sunedison.com
SUNESYS	sunesys.com
SUNETRIC	sunetric.com
SUNFARE	sunfare.com
SUNFED	sunfed.net
SUNFUNDER	sunfunder.com
SUNGARD	sungard.com
SUNGATEKIDS	sungatekids.org
SUNGENX	sungenx.com
SUNGEVITY	sungevity.com
SUNGRAPHIX	sungraphix.com
SUNICE	sunice.com
SUNIDEE	sunidee.com
SUNISTICS	sunistics.com
SUNKING	sunking.com
SUNLIFE	sunlife.com
SUNLINC	sunlinc.net
SUNLINK	sunlink.com
SUNLION	sunlion.com
SUNLYNC	sunlync.com
SUNNCO	sunnco.com
SUNNOVATIONS	sunnovations.com
SUNNYKARMA	sunnykarma.com
SUNNYTECH	sunnytech.com
SUNOP	sunop.com
SUNPAN	sunpan.com
SUNPREME	sunpreme.com
SUNREPORTS	sunreports.com
SUNRISECHURCH	sunrisechurch.org
SUNROC	sunroc.net
SUNROCKET	sunrocket.com
SUNRX	sunrx.com
SUNSET45	sunset45.com
SUNSHINESIGN	sunshinesign.com
SUNSOFTLLC	sunsoftllc.net
SUNSSON	sunsson.com
SUNSTALL	sunstall.com
SUNSTARTER	sunstarter.net
SUNSTONE	sunstone.com
SUNSTREAM	sunstream.com
SUNSTREAMUSA	sunstreamusa.com
SUNSWEET	sunsweet.com
SUNTACTICS	suntactics.com
SUNTAVA	suntava.com
SUNTAYDESIGN	suntaydesign.com
SUNTCO	suntco.com
SUNTELL	suntell.com
SUNTERCPA	suntercpa.com
SUNTIVA	suntiva.com
SUNTORY	suntory.com
SUNTRAND	suntrand.com
SUNTRUST	suntrust.com
SUNTUITY	suntuity.com
SUNVALLEYTEK	sunvalleytek.com
SUNVEST	sunvest.com
SUNWARRIOR	sunwarrior.com
SUNWODA	sunwoda.com
SUNY	suny.edu
SUNYIT	sunyit.edu
SUPAJAM	supajam.com
SUPCO	supco.com
SUPDESIGN	supdesign.com
SUPERABRASIVE	superabrasive.com
SUPERAGENT	superagent.com
SUPERBOLT	superbolt.com
SUPERBULBS	superbulbs.com
SUPERCARDIRECT	supercardirect.com
SUPERCELL	supercell.com
SUPERCLUBS	superclubs.com
SUPERCODER	supercoder.com
SUPERCOMPRESSOR	supercompressor.com
SUPERCOSM	supercosm.com
SUPERDAIRYBOY	superdairyboy.com
SUPERDIMENSION	superdimension.com
SUPEREDNET	superednet.com
SUPERFAD	superfad.com
SUPERFISH	superfish.com
SUPERGEEKS	supergeeks.net
SUPERGEN	supergen.com
SUPERGLUED	superglued.com
SUPERGRAPHICS	supergraphics.com
SUPERGROOVYSTUFF	supergroovystuff.com
SUPERIORDISCOVERY	superiordiscovery.com
SUPERIORHIRE	superiorhire.com
SUPERIORSONICSTV	superiorsonicstv.com
SUPERLUX	superlux.com
SUPERMECHANICAL	supermechanical.com
SUPERMICRO	supermicro.com
SUPERMONEY	supermoney.com
SUPERMUSICVISION	supermusicvision.com
SUPEROCITY	superocity.com
SUPERPEDESTRIAN	superpedestrian.com
SUPERSCAPE	superscape.com
SUPERSHUTTLE	supershuttle.net
SUPERSONICADS	supersonicads.com
SUPERSPORT	supersport.com
SUPERSTRUCTURES	superstructures.com
SUPERTEETH	superteeth.com
SUPERTEX	supertex.com
SUPERTOOTH	supertooth.net
SUPERTRASH	supertrash.com
SUPERUBER	superuber.com
SUPERVALE	supervale.com
SUPERVALU	supervalu.com
SUPERWINDY	superwindy.com
SUPINFO	supinfo.com
SUPLOVE	suplove.com
SUPPERSTUDIO	supperstudio.com
SUPPLAIR	supplair.com
SUPPLEMENTWAREHOUSE	supplementwarehouse.com
SUPPLET	supplet.com
SUPPLIERGATEWAY	suppliergateway.com
SUPPLIERWORKS	supplierworks.com
SUPPLYCHAINBRAIN	supplychainbrain.com
SUPPLYCORE	supplycore.com
SUPPLYDEN	supplyden.com
SUPPLYED	supplyed.com
SUPPLYFORCE	supplyforce.com
SUPPLYHOG	supplyhog.com
SUPPLYKICK	supplykick.com
SUPPLYLOGIC	supplylogic.com
SUPPLYONE	supplyone.com
SUPPLYSCAPE	supplyscape.com
SUPPORTBUDDY	supportbuddy.net
SUPPORTCHOICE	supportchoice.com
SUPPORTKIDS	supportkids.com
SUPPORTLAND	supportland.com
SUPPORTMONK	supportmonk.com
SUPPORTPRO	supportpro.com
SUPPORTPROBE	supportprobe.com
SUPPORTSEVEN	supportseven.com
SUPPURENUTRITION	suppurenutrition.com
SUPRACOR	supracor.com
SUPRAINVEST	suprainvest.com
SUPRANATURALS	supranaturals.com
SUPRATEXT	supratext.com
SUPREMEMETAL	suprememetal.com
SUPREMIA	supremia.com
SURANCEBAY	surancebay.com
SURCOMM	surcomm.com
SURDEX	surdex.com
SURDOC	surdoc.com
SUREBILL	surebill.net
SURECOMP	surecomp.com
SURECRAFT	surecraft.com
SUREDEPOSIT	suredeposit.com
SUREDONE	suredone.com
SUREFIELD	surefield.com
SUREFIL	surefil.com
SUREFIRE	surefire.com
SUREFOOT	surefoot.com
SUREGATE	suregate.net
SUREHARVEST	sureharvest.com
SUREHOLD	surehold.com
SUREPAYROLL	surepayroll.com
SUREQUOTE	surequote.com
SURESCORE	surescore.com
SURESCRIPTS	surescripts.com
SURESHADE	sureshade.com
SURESILL	suresill.com
SURESOURCE	suresource.com
SURESPECT	surespect.net
SURETEC	suretec.com
SUREWEST	surewest.com
SURFACEINK	surfaceink.com
SURFACEQUEST	surfacequest.com
SURFACETECH	surfacetech.com
SURFACEWORX	surfaceworx.com
SURFACEXCHANGE	surfacexchange.com
SURFAID	surfaid.org
SURFBI	surfbi.com
SURFCAM	surfcam.com
SURFCONTROL	surfcontrol.com
SURFERNET	surfernet.com
SURFGURU	surfguru.com
SURFITLOCAL	surfitlocal.com
SURFLINE	surfline.com
SURFMONK	surfmonk.com
SURFNDEAL	surfndeal.com
SURFRAY	surfray.com
SURFSAFEVPN	surfsafevpn.com
SURFSOCIAL	surfsocial.com
SURFTECH	surftech.com
SURGANCE	surgance.com
SURGERYEDU	surgeryedu.com
SURGERYLINK	surgerylink.com
SURGERYPLANET	surgeryplanet.com
SURGEWORKS	surgeworks.com
SURGEX	surgex.com
SURGIMATE	surgimate.com
SURGIONIX	surgionix.com
SURGIQUEST	surgiquest.com
SURGISIL	surgisil.com
SURGITECH	surgitech.org
SURGPRO	surgpro.com
SURMET	surmet.com
SURMODICS	surmodics.com
SURNETICS	surnetics.com
SURPLUS-IT	surplus-it.com
SURROUNDART	surroundart.com
SURS	surs.com
SURS	surs.org
SURTRONICS	surtronics.com
SURVAIT	survait.com
SURVALENT	survalent.com
SURVATA	survata.com
SURVELA	survela.com
SURVEYCONNECT	surveyconnect.com
SURVEYCREST	surveycrest.com
SURVEYGIZMO	surveygizmo.com
SURVEYLAYOUT	surveylayout.com
SURVEYMONKEY	surveymonkey.com
SURVEYRAMP	surveyramp.com
SURVEYUSA	surveyusa.com
SURVIVALBASED	survivalbased.com
SURVIVESTYLE	survivestyle.com
SURVIVINGMYLIFE	survivingmylife.com
SURYA	surya.com
SURYL	suryl.com
SUSD	susd.org
SUSE	suse.com
SUSPENSYS	suspensys.com
SUSPROD	susprod.com
SUSTAINABILITY	sustainability.com
SUSTAINABLEWORKS	sustainableworks.com
SUSTAINALYTICS	sustainalytics.com
SUSTAINAMETRIX	sustainametrix.com
SUSTAINX	sustainx.com
SUSTANE	sustane.com
SUSTOLOGY	sustology.com
SUTERRA	suterra.com
SUTHERLAND	sutherland.com
SUTISOFT	sutisoft.com
SUTRON	sutron.com
SUTTLE-STRAUS	suttle-straus.com
SUVERTIS	suvertis.com
SUZ4HEALTH	suz4health.com
SUZECO	suzeco.com
SVA	sva.com
SVB	svb.com
SVHOME	svhome.com
SVITLA	svitla.com
SVMCONNECT	svmconnect.com
SVMIC	svmic.com
SVOIBIZ	svoibiz.org
SVRCFL	svrcfl.org
SVSU	svsu.edu
SVTC	svtc.com
SVTRONICS	svtronics.com
SVUSD	svusd.org
SVZ	svz.com
SWACHA	swacha.org
SWACO	swaco.org
SWADDLEDESIGNS	swaddledesigns.com
SWAGATUSA	swagatusa.com
SWAGELOK	swagelok.com
SWAGGERBRAND	swaggerbrand.com
SWAGIT	swagit.com
SWANA	swana.org
SWANKFILMS	swankfilms.net
SWAPBOX	swapbox.com
SWAPE	swape.com
SWAPMOB	swapmob.com
SWAPMPA	swapmpa.com
SWAPT	swapt.com
SWAPYOURSHOP	swapyourshop.com
SWAROVSKI	swarovski.com
SWATCHCRAFT	swatchcraft.com
SWATCHGROUP	swatchgroup.com
SWATSPORTS	swatsports.org
SWAYCHIC	swaychic.com
SWAZZLE	swazzle.net
SWBC	swbc.com
SWCA	swca.com
SWCR	swcr.com
SWCSI	swcsi.com
SWEATGURU	sweatguru.com
SWEATWORKS	sweatworks.net
SWECO	sweco.com
SWEDA	sweda.com
SWEDBANK	swedbank.com
SWEDECAR	swedecar.com
SWEDENBIO	swedenbio.com
SWEENEYVESTY	sweeneyvesty.com
SWEEPSHEET	sweepsheet.com
SWEET200	sweet200.com
SWEETCAPTCHA	sweetcaptcha.com
SWEETEN	sweeten.com
SWEETGRASSDAIRY	sweetgrassdairy.com
SWEETGREEN	sweetgreen.com
SWEETJACK	sweetjack.com
SWEETRIOT	sweetriot.com
SWEETSER	sweetser.org
SWELL	swell.com
SWELLBOX	swellbox.com
SWELLHEAD	swellhead.net
SWELLMAGNET	swellmagnet.com
SWELLPATH	swellpath.com
SWELLSHARK	swellshark.com
SWENCO	swenco.com
SWERDLOVE	swerdlove.com
SWERVEPOINT	swervepoint.com
SWFA	swfa.com
SWICORP	swicorp.com
SWIDA	swida.org
SWIFT	swift.com
SWIFTECHS	swiftechs.com
SWIFTKEY	swiftkey.com
SWIFTKNOWLEDGE	swiftknowledge.com
SWIFTLEAD	swiftlead.com
SWIFTMD	swiftmd.com
SWIFTO	swifto.com
SWIFTPAGE	swiftpage.com
SWIFTRACER	swiftracer.com
SWIFTWICK	swiftwick.com
SWIFTYPE	swiftype.com
SWIG	swig.org
SWIM2000	swim2000.com
SWIMCREATIVE	swimcreative.com
SWIMKIDS	swimkids.biz
SWIMKIDS	swimkids.net
SWIMLABS	swimlabs.com
SWIMSUITSFORALL	swimsuitsforall.com
SWIMSWAM	swimswam.com
SWIMWAYS	swimways.com
SWINERTON	swinerton.com
SWINGBOT	swingbot.com
SWINGBYTE	swingbyte.com
SWINGCHICK	swingchick.com
SWINGFRAME	swingframe.com
SWINGPAL	swingpal.com
SWINGTIDE	swingtide.com
SWIPECLOCK	swipeclock.com
SWIPEJOBS	swipejobs.com
SWIPELIFE	swipelife.com
SWIPELY	swipely.com
SWIPENOW	swipenow.com
SWIPEWORKS	swipeworks.com
SWIPP	swipp.com
SWIPPLE	swipple.com
SWIRL	swirl.net
SWISCO	swisco.com
SWISSBAKERS	swissbakers.com
SWISSHIPPO	swisshippo.com
SWISSLOG	swisslog.com
SWISSMOVEMENT	swissmovement.com
SWISSOTEL	swissotel.com
SWISSPORT	swissport.com
SWISSQUOTE	swissquote.com
SWISSTRAX	swisstrax.com
SWITCH	switch.com
SWITCHBLADEVPS	switchbladevps.com
SWITCHCAM	switchcam.com
SWITCHINGGEARS	switchinggears.com
SWITCHLAB	switchlab.com
SWITCHPLACE	switchplace.com
SWITLIK	switlik.com
SWIVL	swivl.com
SWLAW	swlaw.edu
SWM	swm.com
SWOCA	swoca.net
SWODEV	swodev.com
SWOG	swog.org
SWOGA	swoga.org
SWOOP	swoop.com
MAKOVSKY	makovsky.com
MAKPLATE	makplate.com
MAKROSCIENTIFIC	makroscientific.com
MAKRR	makrr.com
MAKSOR	maksor.com
MALABS	malabs.com
MALANDRO	malandro.com
MALANSKI	malanski.com
MALETIS	maletis.com
MALIBUIQ	malibuiq.com
MALIKCO	malikco.com
MALLERYSCORES	malleryscores.com
MALLPAD	mallpad.com
MALLTIP	malltip.com
MALNOVE	malnove.com
MALOMATIA	malomatia.com
MALTBIE	maltbie.com
MALTBYTREE	maltbytree.com
MALTEUROP	malteurop.com
MALZ	malz.com
MAM-A	mam-a.com
MAMEDIAGROUP	mamediagroup.com
MAMMALFISH	mammalfish.com
MAMMOET	mammoet.com
MAMTC	mamtc.com
MANAFORT	manafort.com
MANAGED-MARKETING	managed-marketing.com
MANAGEDPAY	managedpay.com
MANAGEDPRINT	managedprint.com
MANAGEFORCE	manageforce.com
MANAGEMENTPLUS	managementplus.com
MANAGEMOBILITY	managemobility.com
MANAGEPHARMA	managepharma.com
MANAGEPOINT	managepoint.biz
MANAGERCOMPLETE	managercomplete.com
MANAGESERVE	manageserve.com
MANAGISTICS	managistics.com
MANAMIART	manamiart.com
MANASONIC	manasonic.com
MANATRON	manatron.com
MANATT	manatt.com
MANCEF	mancef.org
MANCINIDUFFY	manciniduffy.com
MANDALAH	mandalah.com
MANDALAS	mandalas.com
MANDALAY	mandalay.com
MANDIANT	mandiant.com
MANDUKA	manduka.com
MANE	mane.com
MANE6	mane6.com
MANEKIN	manekin.com
MANETCH	manetch.com
MANEX	manex.biz
MANEX	manex.com
MANGROVE	mangrove.com
MANH	manh.com
MANHATPRO	manhatpro.com
MANHATTANGMAT	manhattangmat.com
MANHATTIST	manhattist.com
MANHEIM	manheim.com
MANHEIMLLC	manheimllc.com
MANIACTOOLS	maniactools.com
MANICUBE	manicube.com
MANIFESTO1	manifesto1.com
MANINHAT	maninhat.com
MANINIS	maninis.com
MANIRASOFT	manirasoft.com
MANITOUNW	manitounw.com
MANITOWOC	manitowoc.com
MANNA-SOLUTIONS	manna-solutions.com
MANNARELIEF	mannarelief.org
MANNATECH	mannatech.com
MANNAZO	mannazo.com
MANNCORP	manncorp.com
MANNINGTON	mannington.com
MANNKRAFT	mannkraft.com
MANOBYTE	manobyte.com
MANPOWER	manpower.com
MANPOWERGROUP	manpowergroup.com
MANROLAND	manroland.com
MANRRS	manrrs.org
MANTA	manta.com
MANTARA	mantara.com
MANTECH	mantech.com
MANTECORP	mantecorp.com
MANTHAN	manthan.biz
MANTISGRIP	mantisgrip.com
MANUSCRIPTEDIT	manuscriptedit.com
MANUSOFT	manusoft.com
MANVELOPE	manvelope.com
MANYETA	manyeta.com
MANYMOON	manymoon.com
MANYSHIP	manyship.com
MANYVOICES	manyvoices.org
MANZAMA	manzama.com
MAOF	maof.org
MAONO	maono.com
MAOSTUDIOS	maostudios.com
TRESTIAN	trestian.com
TRESTLEMEDIA	trestlemedia.com
TRESTLETREE	trestletree.com
TRESYS	tresys.com
TREVECCA	trevecca.edu
TREVERA	trevera.com
TREVIICOS	treviicos.com
TREX	trex.com
TREXA	trexa.com
TREXTEL	trextel.com
TREYSTAR	treystar.com
TREZA	treza.com
TREZTONE	treztone.com
TRI-AD	tri-ad.com
TRI-ANALYTICS	tri-analytics.com
TRI-C	tri-c.edu
TRI-COUNTYFENCE	tri-countyfence.com
TRI-TEL	tri-tel.com
TRI5MEDIA	tri5media.com
TRIA	tria.com
TRIADVENTURE	triadventure.com
TRIADVOCATES	triadvocates.com
TRIAGENCY	triagency.com
TRIAGO	triago.com
TRIAL-NOTES	trial-notes.com
TRIALCARD	trialcard.com
TRIALCO	trialco.net
TRIALNETWORKS	trialnetworks.com
TRIALPAY	trialpay.com
TRIALSMITH	trialsmith.com
TRIANZ	trianz.com
TRIATEK	triatek.com
TRIATTIC	triattic.com
TRIBALCO	tribalco.com
TRIBALMEDIA	tribalmedia.com
TRIBALVISION	tribalvision.com
TRIBCO	tribco.com
TRIBE	tribe.net
TRIBERR	triberr.com
TRIBESOUND	tribesound.com
TRIBESPORTS	tribesports.com
TRIBESWELL	tribeswell.com
TRIBRIDGE	tribridge.com
TRIBUNE	tribune.com
TRICALYX	tricalyx.com
TRICENSION	tricension.com
TRICENTIS	tricentis.com
TRICENTURION	tricenturion.com
TRICERAT	tricerat.com
TRICITYSQUAD	tricitysquad.com
TRICKLESTAR	tricklestar.com
TRICO	trico.com
TRICOAST	tricoast.com
TRICOLOR	tricolor.com
TRICOMB2B	tricomb2b.com
TRICONTINENT	tricontinent.com
TRICORBRAUN	tricorbraun.com
TRIDAK	tridak.com
TRIDENTIS	tridentis.com
TRIDERMA	triderma.com
TRIDH	tridh.com
TRIDIGITAL	tridigital.com
TRIDIUM	tridium.com
TRIENDA	trienda.com
TRIENDLY	triendly.com
TRIESCA	triesca.com
TRIFACTOR	trifactor.com
TRIFOLIUM	trifolium.com
TRIFOUND	trifound.com
TRIFUSION	trifusion.com
TRIGGERONE	triggerone.com
TRIGGIT	triggit.com
TRIGILD	trigild.com
TRIGRAMS	trigrams.org
TRIHEALTH	trihealth.com
TRIHEDRAL	trihedral.com
TRIHYDRO	trihydro.com
TRILEMETRY	trilemetry.com
TRILIBRIUM	trilibrium.com
TRILITHIC	trilithic.com
TRILLENIUM	trillenium.com
TRILLION	trillion.net
TRILOGIC	trilogic.com
TRILOGY	trilogy.com
TRILOTECH	trilotech.com
TRILUMINA	trilumina.com
TRILUXE	triluxe.com
TRIMAC	trimac.com
TRIMACO	trimaco.com
TRIMBLE	trimble.com
TRIMEDX	trimedx.com
TRIMEGA	trimega.org
TRIMERGENCE	trimergence.com
TRIMET	trimet.org
TRIMIKE	trimike.com
TRIMINGHAM	trimingham.com
TRIMLITE	trimlite.com
TRIMOTION	trimotion.com
TRIMQUICK	trimquick.com
TRINACLE	trinacle.com
TRINAMIX	trinamix.com
TRINAN	trinan.com
TRINARYART	trinaryart.com
TRINDCO	trindco.com
TRINET	trinet.com
TRINISYS	trinisys.com
TRINKIT	trinkit.com
TRINNOVATIONS	trinnovations.com
TRINONA	trinona.com
TEKVAL	tekval.org
TEKVITALS	tekvitals.com
TEKVIZION	tekvizion.com
TEKWELD	tekweld.com
TEKWERKS	tekwerks.com
TEKWERX	tekwerx.com
TEKWORKS	tekworks.com
TEKXCEL	tekxcel.com
TEKYN	tekyn.com
TEKZALL	tekzall.com
TEL	tel.com
TELACU	telacu.com
TELADATA	teladata.com
TELAFFECTS	telaffects.com
TELAID	telaid.com
TELAIRITY	telairity.com
TELALASKA	telalaska.com
TELANIA	telania.com
TELAPPRISE	telapprise.com
TELARGO	telargo.com
TELARIX	telarix.com
TELARUS	telarus.com
TELAUTHORITY	telauthority.com
TELCAN	telcan.com
TELCARE	telcare.com
TELCEL	telcel.com
TELCENTRIS	telcentris.com
TELCOIQ	telcoiq.com
TELCOMP	telcomp.com
TELCOMTEC	telcomtec.com
TELCOPACIFIC	telcopacific.com
TELCOR	telcor.com
TELCORDIA	telcordia.com
TELDATA	teldata.com
TELDESIGNS	teldesigns.com
TELE-OPTICS	tele-optics.com
TELE2	tele2.com
TELEADAPT	teleadapt.com
TELEAMERICA	teleamerica.com
TELEARK	teleark.com
TELEBAY	telebay.com
TELEBLEND	teleblend.com
TELEBRANDS	telebrands.com
TELEBROAD	telebroad.com
TELECENTRICS	telecentrics.com
TELECENTS	telecents.com
TELECHECK	telecheck.com
TELECO	teleco.com
TELECOM180	telecom180.com
TELECOM411	telecom411.net
TELECOMAFRICA	telecomafrica.org
TELECOMEX	telecomex.com
TELECOMMEDIC	telecommedic.com
TELECOMPAPER	telecompaper.com
TELECONSULTANCY	teleconsultancy.net
TELECONVERGENCE	teleconvergence.com
TELECOPY	telecopy.com
TELECORE	telecore.com
TELECT	telect.com
TELECUBA	telecuba.com
TELECYCLING	telecycling.net
TELEDEVELOPMENT	teledevelopment.com
TELEDEX	teledex.com
TELEDINI	teledini.com
TELEDNA	teledna.com
TELEDYNAMICS	teledynamics.com
TELEDYNAMICX	teledynamicx.com
TELEDYNE	teledyne.com
TELEFLEX	teleflex.com
TELEFLORA	teleflora.com
TELEFORMIX	teleformix.com
TELEGEOGRAPHY	telegeography.com
TELEGO	telego.com
TELEGRAPHICMEDIA	telegraphicmedia.com
TELEHAMMERS	telehammers.com
TELEHOUSE	telehouse.net
TELEKENEX	telekenex.com
TELELANGUAGE	telelanguage.com
TELELINK	telelink.com
TELELOGIC	telelogic.com
TELEMARK	telemark.com
TELEMATRIX	telematrix.net
TELEMEDX	telemedx.com
TELEMESSAGE	telemessage.com
TELEMETRY	telemetry.com
TELEMETRYWEB	telemetryweb.com
TELEMPATH	telempath.com
TELEMUNDO	telemundo.com
TELENAV	telenav.com
TELENECT	telenect.com
TELENETWORK	telenetwork.com
TELENITY	telenity.com
TELENNIA	telennia.net
TELENOTES	telenotes.net
TELENT	telent.com
TELEOPTI	teleopti.com
TELEOPTIONS	teleoptions.net
TELEPACIFIC	telepacific.com
TELEPARENT	teleparent.net
TELEPAYROLL	telepayroll.com
TELEPERFORMANCE	teleperformance.com
TELEPHONE	telephone.com
TELEPHONETICS	telephonetics.com
TELEPHONICS	telephonics.com
TELEPLAN	teleplan.com
TELEPRESS	telepress.com
TELEPROVIDERS	teleproviders.com
TELEREP	telerep.com
TELERIK	telerik.com
TELERUS	telerus.com
TELERX	telerx.com
TELESAGE	telesage.com
TELESCAN	telescan.net
TELESIGHT	telesight.com
TELESIGN	telesign.com
TELESPAZIO	telespazio.com
TELESPEX	telespex.com
TELESPHERE	telesphere.com
TELESTAX	telestax.com
TELESTE	teleste.com
TELESTRATEGIES	telestrategies.com
TELESTREAM	telestream.net
TELESWITCH	teleswitch.com
TELESYS	telesys.com
TELETECH	teletech.com
TELETRAC	teletrac.net
TELETRACKING	teletracking.com
TELETRAVEL	teletravel.net
TELETRIX	teletrix.com
TELEVERDE	televerde.com
TELEVERSIONS	televersions.com
TELEVIC	televic.com
TELEVISION101	television101.net
TELEZENT	telezent.com
TELGIAN	telgian.com
TELIAPP	teliapp.com
TELIGENTEMS	teligentems.com
TELIGISTICS	teligistics.com
TELIGY	teligy.com
TELINTEL	telintel.net
TELIRIS	teliris.com
TELKONET	telkonet.com
TELKOOR	telkoor.com
TELLABS	tellabs.com
TELLAGAMI	tellagami.com
TELLAGENCE	tellagence.com
TELLAGO	tellago.com
TELLART	tellart.com
TELLASON	tellason.com
TELLEPSEN	tellepsen.com
TELLERMATE	tellermate.com
TELLIGENT	telligent.com
TELLIGYS	telligys.com
TELLUREX	tellurex.com
TELLUS360	tellus360.com
TELLWISE	tellwise.com
TELLY	telly.com
TELLYJUICE	tellyjuice.com
TELMAP	telmap.com
TELMEX	telmex.com
TELNEXT	telnext.com
TELNYX	telnyx.com
TELOG	telog.com
TELOGIS	telogis.com
TELOPHASE	telophase.com
TELOS	telos.com
TELOSA	telosa.com
TELOSRT	telosrt.com
TELREX	telrex.com
TELSASOFT	telsasoft.com
TELSERV	telserv.com
TELSIMA	telsima.com
TELSMITH	telsmith.com
TELSPAN	telspan.com
TELSTRAT	telstrat.com
TELSYSTEMS	telsystems.com
TELTRONIC	teltronic.com
TELTRONICS	teltronics.com
TELULAR	telular.com
TELWARES	telwares.com
TELWORX	telworx.com
TELX	telx.com
TELXTRA	telxtra.com
TELZIO	telzio.com
TEMBOO	temboo.com
TEMBUA	tembua.com
TEMENOS	temenos.com
TEMIS	temis.com
TEMP-AIR	temp-air.com
TEMPACO	tempaco.com
TEMPEL	tempel.com
TEMPESTUALITY	tempestuality.com
TEMPFORCE	tempforce.com
TEMPLAMATIC	templamatic.com
TEMPLATEMONSTER	templatemonster.com
TEMPLE	temple.edu
TEMPOHIO	tempohio.com
TEMPRESCO	tempresco.com
TEMPSERVERS	tempservers.com
TEMPSTAFF	tempstaff.net
TEMPSYS	tempsys.net
TEMPTU	temptu.com
TEN19ESTIMATING	ten19estimating.com
TEN3	ten3.org
TENACORE	tenacore.com
TENACRE	tenacre.org
TENANT	tenant.com
TENANTBASE	tenantbase.com
TENANTREX	tenantrex.com
TENANTSOLUTION	tenantsolution.com
TENARIS	tenaris.com
TENARISTAMSA	tenaristamsa.com
TENASKA	tenaska.com
TENAXUSA	tenaxusa.com
TENCARVA	tencarva.com
TENCATE	tencate.com
TENCOM	tencom.com
TENDEKA	tendeka.com
TENDELTA	tendelta.com
TENDERHEARTS	tenderhearts.net
TENDERLING	tenderling.com
TENDIGI	tendigi.com
TENDONUSA	tendonusa.com
TENDOTO	tendoto.com
TENENTIA	tenentia.com
TENEOTALENT	teneotalent.com
TENERE	tenere.com
TENERGY	tenergy.com
TENEROS	teneros.com
TENESIS	tenesis.com
TENFOLDRESULTS	tenfoldresults.com
TENGRADE	tengrade.com
TENLEGS	tenlegs.com
TENLINKS	tenlinks.com
TENNADYNE	tennadyne.com
TENNALUM	tennalum.com
TENNECO	tenneco.com
TENNIS	tennis.com
TENNISHUB	tennishub.com
TENROX	tenrox.com
TENSENTRIC	tensentric.com
TENSHON	tenshon.com
TENSILICA	tensilica.com
TENSING	tensing.com
TENSOFT	tensoft.com
TENSORCOM	tensorcom.com
TENSORMAP	tensormap.com
TENSTREET	tenstreet.com
TENTCRAFT	tentcraft.com
TENTEN71	tenten71.com
TENTHOUSANDVISIONS	tenthousandvisions.com
TENTIKO	tentiko.com
TENTLOGIX	tentlogix.com
TENTWARES	tentwares.com
TENURGY	tenurgy.com
TEOCO	teoco.com
TEPE	tepe.com
TEPHRAMEDIA	tephramedia.com
TEPINO	tepino.com
TEQLEASE	teqlease.com
TEQSUPPLY	teqsupply.com
TEQWORKS	teqworks.com
TERABITEDENTAL	terabitedental.com
TERABRITE	terabrite.com
TERACAI	teracai.com
TERACO	teraco.com
TERACODE	teracode.com
TERACORE	teracore.com
TERADATA	teradata.com
TERADICI	teradici.com
TERADIODE	teradiode.com
TERADYNE	teradyne.com
TERAEXCHANGE	teraexchange.com
TERAGREN	teragren.com
TERALOGICS	teralogics.com
TERAMEDICA	teramedica.com
TERANOMIC	teranomic.com
TERAPEAK	terapeak.com
TERAPIO	terapio.com
TERARECON	terarecon.com
TERASCALA	terascala.com
TERASCI	terasci.com
TERATEKNE	teratekne.com
TERAVIEW	teraview.com
TERAXION	teraxion.com
TERC	terc.edu
TEREM	terem.com
TERENINE	terenine.com
TEREPAC	terepac.com
TEREX	terex.com
TERI	teri.org
TERIDA	terida.com
TERILLION	terillion.com
TERILLIUM	terillium.com
TERMINAL	terminal.com
TERMINALB	terminalb.com
TERMINIX	terminix.com
TERMLIFEMAX	termlifemax.com
TERMSCOUT	termscout.com
TERMTEGRITY	termtegrity.com
TERNPRO	ternpro.com
TERPSYS	terpsys.com
TERRA-MAR	terra-mar.net
TERRA-SAN	terra-san.com
TERRABANK	terrabank.com
TERRABUILT	terrabuilt.com
TERRACON	terracon.com
TERRACRG	terracrg.com
TERRACYCLE	terracycle.net
TERRADATUM	terradatum.com
TERRAFUGIA	terrafugia.com
TERRALEVER	terralever.com
TERRALEX	terralex.org
TERRALIGN	terralign.com
TERRALUX	terralux.com
TERRAMAI	terramai.com
TERRANEARPMC	terranearpmc.com
TERRASCIENCES	terrasciences.com
TERRASMART	terrasmart.com
TERRASTOCH	terrastoch.com
TERRASURV	terrasurv.com
TERRATHERM	terratherm.com
TERRATHERMAL	terrathermal.com
TERRAXML	terraxml.com
TERRAXPLORATIONS	terraxplorations.com
TERREGEN	terregen.com
TERREMARK	terremark.com
TERRENEW	terrenew.com
TERRESCAPE	terrescape.com
TERROS	terros.org
TERROSTAR	terrostar.com
TERRYBERRY	terryberry.com
TERSA	tersa.cat
TERSANO	tersano.com
TERVELA	tervela.com
TERVIS	tervis.com
TERVIVA	terviva.com
TESCRA	tescra.com
TESLAGOVERNMENT	teslagovernment.com
TESORA	tesora.com
TESSCO	tessco.com
TESSEMAES	tessemaes.com
TESSERA	tessera.com
TESSUTA	tessuta.com
TESTAMERICAINC	testamericainc.com
TESTCORP	testcorp.net
TESTEACHERS	testeachers.com
TESTEAGLE	testeagle.com
TESTECH	testech.com
TESTEQUITY	testequity.com
TESTHOUND	testhound.com
TESTHOUSE	testhouse.net
TESTINGXPERTS	testingxperts.com
TESTOIL	testoil.com
TESTPLANT	testplant.com
TESTRA	testra.com
TESTRAC	testrac.com
TESTRACK	testrack.com
TESTSOUP	testsoup.com
TESTUDODATA	testudodata.com
TESTUP	testup.com
TESTVONICS	testvonics.com
TESTWERX	testwerx.com
TETEA	tetea.org
TETHIS	tethis.com
TETRA4D	tetra4d.com
TETRABRAZIL	tetrabrazil.com
TETRACTYS	tetractys.net
TETRAFAB	tetrafab.com
TETRAPAK	tetrapak.com
TETRATECH	tetratech.com
TETRUS	tetrus.com
TEUTSCHPROPERTIES	teutschproperties.com
TEVIXMD	tevixmd.com
TEVORA	tevora.com
TEXAGS	texags.com
TEXALOY	texaloy.com
TEXANACENTER	texanacenter.com
TEXAROM	texarom.com
TEXASCARSDIRECT	texascarsdirect.com
TEXASREALTYPROS	texasrealtypros.com
TEXBASE	texbase.com
TEXBEST	texbest.com
TEXFABCO	texfabco.com
TEXIUM	texium.com
TEXLYNX	texlynx.com
TEXMARK	texmark.com
TEXOLLINI	texollini.com
TEXOLUTION	texolution.com
TEXPRINT	texprint.com
TEXPTS	texpts.com
TEXSPORT	texsport.com
TEXSTAFF	texstaff.net
TEXT100	text100.com
TEXT2THEM	text2them.com
TEXT4WORK	text4work.com
TEXTAIM	textaim.com
TEXTCASTER	textcaster.com
TEXTILERIA	textileria.net
TEXTIVIA	textivia.com
TEXTLIVING	textliving.com
TEXTMASTER	textmaster.com
TEXTME4DEALS	textme4deals.com
TEXTMUNICATION	textmunication.com
TEXTMYBRAIN	textmybrain.com
TEXTMYFOOD	textmyfood.com
TEXTON	texton.com
TEXTPLUS	textplus.com
TEXTPOWER	textpower.com
TEXTRECRUIT	textrecruit.com
TEXTRON	textron.com
TEXTWISE	textwise.com
TEXUPORT	texuport.com
TEXZON	texzon.net
TEYJAS	teyjas.com
TFHNY	tfhny.org
TFNN	tfnn.com
TFUMC	tfumc.com
TG170	tg170.com
TGEN	tgen.org
TGERMAN	tgerman.com
TGKY	tgky.com
TGM2	tgm2.com
TGPOWERHOUSE	tgpowerhouse.com
TGRWA	tgrwa.com
TGSP	tgsp.com
TGW	tgw.com
TH3FACTORY	th3factory.com
THACHOPSHOP	thachopshop.com
THAERES	thaeres.com
THAKOON	thakoon.com
THALESNANO	thalesnano.com
THALHIMER	thalhimer.com
THANKUZ	thankuz.com
THAOINC	thaoinc.com
THARCO	tharco.com
THAT1STORE	that1store.com
THATAGENCY	thatagency.com
THATFREETHING	thatfreething.com
THATGAMECOMPANY	thatgamecompany.com
THAYERNET	thayernet.com
THE4COLOR	the4color.com
THE705	the705.org
THESIXSIGMAWAY	thesixsigmaway.com
THESOCIALGUYS	thesocialguys.com
THESQUAREFOOT	thesquarefoot.com
THESTREET	thestreet.com
THESUITEST	thesuitest.com
THESUPPLY	thesupply.com
THESYSTEMCONSULTANTS	thesystemconsultants.com
THETALKLIST	thetalklist.com
THETARAY	thetaray.com
THETECHUPLOAD	thetechupload.com
THETEKBENCH	thetekbench.com
THETENETWORK	thetenetwork.com
THETESTCO2	thetestco2.com
THETFORD	thetford.com
THETRAFFICAGENCY	thetrafficagency.com
THEVISUALMD	thevisualmd.com
THEWEALTHSOURCE	thewealthsource.com
THEWEBDEPT	thewebdept.biz
THEWIMZY	thewimzy.com
THEWIREDWOMAN	thewiredwoman.com
THEWRAP	thewrap.com
THEWRITECORNER	thewritecorner.com
THIGHGLIDER	thighglider.com
THILLENS	thillens.com
THIN-NOLOGY	thin-nology.com
THINAIRE	thinaire.net
THINGKENTERTAINMENT	thingkentertainment.com
THINGMAGIC	thingmagic.com
THINGWORX	thingworx.com
THINIX	thinix.com
THINK-ISRAEL	think-israel.org
THINK2PERFORM	think2perform.com
THINK81	think81.com
THINKABOUTMARKETING	thinkaboutmarketing.com
THINKALCHEMY	thinkalchemy.com
THINKAPPS	thinkapps.com
THINKASG	thinkasg.com
THINKATOMIC	thinkatomic.com
THINKBENCH	thinkbench.net
THINKBREATHELIVE	thinkbreathelive.com
THINKBROOKLYN	thinkbrooklyn.org
THINKBRQ	thinkbrq.com
THINKCERCA	thinkcerca.com
THINKCREATIVE	thinkcreative.com
THINKDM2	thinkdm2.com
THINKDOGZ	thinkdogz.com
THINKERSMITH	thinkersmith.org
THINKFIND	thinkfind.com
THINKFIRE	thinkfire.com
THINKFIRST	thinkfirst.biz
THINKFIT	thinkfit.com
THINKFOODGROUP	thinkfoodgroup.com
THINKFOREX	thinkforex.com
THINKFUL	thinkful.com
THINKGARD	thinkgard.com
THINKGATE	thinkgate.com
THINKGEEK	thinkgeek.com
THINKGEO	thinkgeo.com
THINKHAMMER	thinkhammer.com
THINKINGAHEAD	thinkingahead.com
THINKINGSHEEP	thinkingsheep.com
THINKLA	thinkla.org
THINKLABS	thinklabs.com
THINKLIQUIDITY	thinkliquidity.com
THINKLITE	thinklite.com
THINKLOGIC	thinklogic.com
THINKLOGICAL	thinklogical.com
THINKMAP	thinkmap.com
THINKMODO	thinkmodo.com
THINKNEAR	thinknear.com
THINKORBIT	thinkorbit.com
THINKORY	thinkory.com
THINKOV	thinkov.com
THINKPATH	thinkpath.com
THINKPLANET	thinkplanet.com
THINKRAZOR	thinkrazor.com
THINKRELIABILITY	thinkreliability.com
THINKSEM	thinksem.com
THINKSF	thinksf.com
THINKSHOUT	thinkshout.com
THINKSOUND	thinksound.com
THINKSTRATEGY	thinkstrategy.org
THINKSTREAM	thinkstream.com
THINKTANKIT	thinktankit.com
THINKTROOP	thinktroop.com
THINKTUSCAN	thinktuscan.com
THINKVINE	thinkvine.com
THINKWELL	thinkwell.com
THINOPTICS	thinoptics.com
THINQSHIFT	thinqshift.com
THINSPRING	thinspring.com
THINWARE	thinware.net
THINX	thinx.net
THIRD-CULTURE	third-culture.com
THIRDCHANNEL	thirdchannel.com
THIRDPYRAMID	thirdpyramid.com
THIRDTHING	thirdthing.com
THIRTEEN23	thirteen23.com
THISCLICKS	thisclicks.com
THISMOMENT	thismoment.com
THISWEBHOST	thiswebhost.com
THISWILDLIFE	thiswildlife.com
THMH	thmh.net
THOMARIOS	thomarios.com
THOMASARTS	thomasarts.com
THOMASCORP	thomascorp.com
THOMASNET	thomasnet.com
THOMLER	thomler.com
THOMPSON-FISHER	thompson-fisher.com
THOMPSONGAS	thompsongas.com
THOMSON	thomson.com
THOMSON	thomson.net
THOMSONREUTERS	thomsonreuters.com
THORATEC	thoratec.com
THOREENHALE	thoreenhale.com
THORLABS	thorlabs.com
THORLO	thorlo.com
THORNTONCPA	thorntoncpa.com
THOROBID	thorobid.com
THOROVET	thorovet.com
THORTEX	thortex.com
THORVATION	thorvation.com
THOSHOGRAPHY	thoshography.com
THOSPITALITY	thospitality.com
THOTBOX	thotbox.com
THOUGHTAGG	thoughtagg.com
THOUGHTBOT	thoughtbot.com
THOUGHTFAUCET	thoughtfaucet.com
THOUGHTLAB	thoughtlab.com
THOUGHTLEAD	thoughtlead.com
THOUGHTLEADR	thoughtleadr.com
THOUGHTSTEM	thoughtstem.com
THOUGHTWORKS	thoughtworks.com
THQ	thq.com
THRDPLACE	thrdplace.com
THRE3	thre3.com
THRE3D	thre3d.com
THREAD	thread.org
THREADFORCE	threadforce.com
THREADHANDED	threadhanded.com
THREADMEUP	threadmeup.com
THREADPOINT	threadpoint.com
THREADSFORED	threadsfored.com
THREADSTAR	threadstar.com
THREATGRID	threatgrid.com
THREATGUARD	threatguard.com
THREATMETRIX	threatmetrix.com
THREATSIM	threatsim.com
THREATSTREAM	threatstream.com
THREDS	threds.com
THREE29	three29.com
THREEASFOUR	threeasfour.com
THREEBRIDGE	threebridge.com
THREECELL	threecell.com
THREEHOUSE	threehouse.com
THREEPOST	threepost.com
THREESPOT	threespot.com
THREEVOLTS	threevolts.com
THREEWILL	threewill.com
THREEWIRE	threewire.com
THRELA	threla.com
THRESHOLDS	thresholds.org
THRG	thrg.org
THRIEV	thriev.com
THRIFTJUNCTION	thriftjunction.com
THRIFTOPHILE	thriftophile.com
THRIIVE	thriive.org
THRILLBUCKET	thrillbucket.com
THRILLIST	thrillist.com
THRIVE15	thrive15.com
THRIVEMETRICS	thrivemetrics.com
THRIVENT	thrivent.com
THRIVEON	thriveon.com
THRIVEON	thriveon.net
THRIVERX	thriverx.net
THRIVEWORKS	thriveworks.com
THROMBOGENICS	thrombogenics.com
THUMBFOUND	thumbfound.com
THUMBSPIRE	thumbspire.com
THUMBSTIR	thumbstir.com
THUNDER11	thunder11.com
THUNDERACTIVE	thunderactive.com
THUNDERBIRD	thunderbird.edu
THUNDERMAX	thundermax.com
THUNDERPAW	thunderpaw.com
THUNDERPUPPET	thunderpuppet.com
THUNDERSOFT	thundersoft.com
THUNDRLIZARD	thundrlizard.com
THURAYA	thuraya.com
THUS	thus.net
THUUZ	thuuz.com
THUZI	thuzi.com
THUZIO	thuzio.com
THVM	thvm.com
THYBERGLAW	thyberglaw.com
THYCOTIC	thycotic.com
THYLAKSOFT	thylaksoft.com
THYMES	thymes.com
THYMESHARE	thymeshare.net
THYNC	thync.com
THYSSENKRUPP	thyssenkrupp.com
TI	ti.com
TIAA-CREF	tiaa-cref.org
TIAG	tiag.net
TIBBR	tibbr.com
TIBCO	tibco.com
TIBERSOFT	tibersoft.com
TIBI	tibi.com
TICGLOBAL	ticglobal.com
TICKELOPES	tickelopes.com
TICKERI	tickeri.com
TICKET2FORTUNE	ticket2fortune.net
TICKETBISCUIT	ticketbiscuit.com
TICKETBUD	ticketbud.com
TICKETBUST	ticketbust.com
TICKETCITY	ticketcity.com
TICKETDERBY	ticketderby.com
TICKETEVOLUTION	ticketevolution.com
TICKETFLY	ticketfly.com
TICKETFORCE	ticketforce.com
TICKETLEAP	ticketleap.com
TICKETMASTER	ticketmaster.com
TICKETNETWORK	ticketnetwork.com
TICKETOMETER	ticketometer.com
TICKETON	ticketon.com
TICKETRETURN	ticketreturn.com
TICKETSHOST	ticketshost.com
TICKETSOCKET	ticketsocket.com
TICKETUL	ticketul.com
TICKETWEB	ticketweb.com
TICKETWOOD	ticketwood.com
TICKETWORKS	ticketworks.com
TICKPICK	tickpick.com
TICLA	ticla.com
TICONA	ticona.com
TICONTRACT	ticontract.com
TIDALSCALE	tidalscale.com
TIDALSEVEN	tidalseven.com
TIDALWHEEL	tidalwheel.com
TIDBITTS	tidbitts.com
TIDE-MARK	tide-mark.com
TIDES	tides.org
TIDF	tidf.com
TIE	tie.net
TIE	tie.org
TIEKS	tieks.com
TIERCON	tiercon.com
TIERPOINT	tierpoint.com
TIETECHNOLOGY	tietechnology.com
TIETEX	tietex.com
TIFFANY	tiffany.com
TIFFEN	tiffen.com
TIFIBER	tifiber.com
TIG	tig.com
TIGENIX	tigenix.com
TIGERCHEF	tigerchef.com
TIGERCOM	tigercom.net
TIGERDIRECT	tigerdirect.com
TIGERINK	tigerink.net
TIGERPAYOUT	tigerpayout.com
TIGERPRESS	tigerpress.com
TIGERSPIKE	tigerspike.com
TIGERSTOP	tigerstop.com
TIGERTEXT	tigertext.com
TIGERTRADE	tigertrade.com
TIGERTRIBE	tigertribe.com
TIGERWEBBY	tigerwebby.com
TIGERZOOM	tigerzoom.com
TIGGLY	tiggly.com
TIGRISNET	tigrisnet.net
TIHUNTER	tihunter.com
TIIZII	tiizii.com
TIKAB	tikab.org
TIKITUM	tikitum.com
TIKKL	tikkl.com
TIKPIX	tikpix.com
TILDA	tilda.com
TILEAMERICA	tileamerica.com
TILEBAR	tilebar.com
TILINGA	tilinga.com
TILITE	tilite.com
TILLART	tillart.net
TILLYS	tillys.com
TILOFY	tilofy.com
TILTFACTOR	tiltfactor.org
TILTIFY	tiltify.com
TILTINGWINDMILLS	tiltingwindmills.com
TILTPIXEL	tiltpixel.com
TILTWORKS	tiltworks.com
TIMBER	timber.net
TIMBERCON	timbercon.com
TIMBERCREST	timbercrest.org
TIMBERGIRL	timbergirl.com
TIMBERKING	timberking.com
TIMBERLAND	timberland.com
TIMBERLANE	timberlane.com
TIMBERSTAR	timberstar.com
TIMBERSTEAD	timberstead.com
TIMBERTECH	timbertech.com
TIMBOOKTU	timbooktu.com
TIMBUKTOONS	timbuktoons.com
TIMCAL	timcal.com
TIME-PLUS	time-plus.com
TIME2HOOP	time2hoop.com
TIME4DESIGN	time4design.net
TIME4LEARNING	time4learning.com
TIMEBOXED	timeboxed.com
TIMEBUYER	timebuyer.com
TIMEC	timec.com
TIMECENTRE	timecentre.com
TIMECOMET	timecomet.com
TIMEFORGE	timeforge.com
TIMEFUL	timeful.com
TIMEHOP	timehop.com
TIMELYTEXT	timelytext.com
TIMEOUT4	timeout4.com
TIMEPAYS	timepays.com
TIMEPERKS	timeperks.com
TIMERAZOR	timerazor.com
TIMESDAILY	timesdaily.com
TIMESHAREWARE	timeshareware.com
TIMESHOUT	timeshout.com
TIMESOFT	timesoft.com
TIMET	timet.com
TIMETRIC	timetric.com
TIMEX	timex.com
TIMEZONEONE	timezoneone.com
TIMINGCUBE	timingcube.com
TIMKEN	timken.com
TIMOCCO	timocco.com
TIMOTCA	timotca.org
TIMREE	timree.com
TIMSCO	timsco.net
TINBU	tinbu.com
TINCAN	tincan.org
TINET	tinet.net
TINITRON	tinitron.com
TINKERFLY	tinkerfly.com
TINKERTASK	tinkertask.com
TINLIST	tinlist.com
TINSCAPE	tinscape.com
TINTEKS	tinteks.com
TINTRI	tintri.com
TINTRONICS	tintronics.com
TINTYPEBOOTH	tintypebooth.com
TINYCIRCUITS	tinycircuits.com
TINYHABIT	tinyhabit.com
TINYHR	tinyhr.com
TINYPASS	tinypass.com
TINYPINT	tinypint.com
TIODIZE	tiodize.com
TIPBIT	tipbit.com
TIPCLUB	tipclub.com
TIPPINGGARDNER	tippinggardner.com
TIPRANKS	tipranks.com
TIPRO	tipro.org
TIPSNTRENDS	tipsntrends.com
TIPTAL	tiptal.com
TIQIQ	tiqiq.com
TIRERACK	tirerack.com
TIREVAN	tirevan.com
TISANO	tisano.com
TISCOR	tiscor.com
TISHCON	tishcon.com
TISHMANSPEYER	tishmanspeyer.com
TITABONITA	titabonita.com
TITANEER	titaneer.com
TITANEYE	titaneye.com
TITBIT	titbit.com
TITLEBOXING	titleboxing.com
TITLENEXUS	titlenexus.com
TITLEPRO	titlepro.com
TITLESMART	titlesmart.com
TITLEVEST	titlevest.com
TITMOUSE	titmouse.net
TITO	tito.com
TITOMA	titoma.com
TITUSPLUS	titusplus.com
TIVERITY	tiverity.com
TIVILON	tivilon.com
TIVO	tivo.com
TIVOL	tivol.com
TIWEBMASTER	tiwebmaster.com
TIXBANGBOOM	tixbangboom.com
TIXMIXER	tixmixer.com
TIXR	tixr.com
TIZEWELL	tizewell.com
TIZRA	tizra.com
TJETS	tjets.net
TJFS	tjfs.org
TJG-DESIGNS	tjg-designs.com
TJKM	tjkm.com
TJOOS	tjoos.com
TJRHCC	tjrhcc.org
TJS	tjs.com
TJSOL	tjsol.com
TJWESTLAKE	tjwestlake.com
TJX	tjx.com
TK1SC	tk1sc.com
TKCA	tkca.com
TKDA	tkda.com
TKLABS	tklabs.com
MOUNTAINSMITH	mountainsmith.com
MOUNZA	mounza.com
MOURANT	mourant.com
MOURIK	mourik.com
MOURMECHE	mourmeche.com
MOUSEFLOW	mouseflow.com
MOUSEGRAPHICS	mousegraphics.com
MOUSEHOUSEAPP	mousehouseapp.com
MOUSESURPLUS	mousesurplus.com
MOUSETRAPPE	mousetrappe.com
MOUTH	mouth.com
MOVABLE	movable.com
MOVASTONE	movastone.com
MOVE	move.com
MOVE2DENVER	move2denver.com
MOVE4	move4.net
MOVEBUILDER	movebuilder.com
MOVECIRCLES	movecircles.com
MOVELLAS	movellas.com
MOVEMAXX	movemaxx.net
MOVEMBER	movember.com
MOVEMENT4LIFE	movement4life.net
MOVEMENTFORWARD	movementforward.com
MOVEN	moven.com
MOVEX	movex.com
MOVFITNESS	movfitness.com
MOVIAL	movial.com
MOVIDEA	movidea.com
MOVIDIUS	movidius.com
MOVIELABS	movielabs.com
MOVIELALA	movielala.com
MOVIELINK	movielink.com
MOVIEPASS	moviepass.com
MOVIES101	movies101.org
MOVIESTARPLANET	moviestarplanet.com
MOVIESTOP	moviestop.com
MOVILE	movile.com
MOVILWAY	movilway.com
MOVIMED	movimed.com
MOVINGDNEEDLE	movingdneedle.com
MOVINGIMAGE24	movingimage24.com
MOVINGSTILLPIX	movingstillpix.com
MOVINGWORLDS	movingworlds.org
MOVIOLA	moviola.com
MOVOTO	movoto.com
MOWAITER	mowaiter.com
MOWALLA	mowalla.com
MOWAVE	mowave.com
MOWEATHER	moweather.com
MOXGEAR	moxgear.com
MOXIEGREEN	moxiegreen.com
MOXIEQ	moxieq.com
MOXII	moxii.com
MOXIZE	moxize.com
MOXTEK	moxtek.com
MOXTRA	moxtra.com
MOXXOR	moxxor.com
MOYEWHITE	moyewhite.com
MOZ	moz.com
MOZAIK	mozaik.com
MOZENDA	mozenda.com
MOZEO	mozeo.com
MOZIDO	mozido.com
MOZILLA	mozilla.org
MOZIO	mozio.com
MOZU	mozu.org
MOZY	mozy.com
MOZY	mozy.net
MOZZERIA	mozzeria.com
MOZZIGN	mozzign.com
MOZZOTECH	mozzotech.com
MPACTWEALTH	mpactwealth.com
MPARTICLE	mparticle.com
MPAY2PARK	mpay2park.com
MPAYGATEWAY	mpaygateway.com
MPCC	mpcc.edu
MPEA	mpea.com
MPECU	mpecu.com
MPG	mpg.com
MPGROUP	mpgroup.com
MPHASIS	mphasis.com
MPHC	mphc.com
MPHCA	mphca.com
MPHI	mphi.org
MPIC	mpic.com
MPIPHP	mpiphp.org
MPIRIK	mpirik.com
MPISD	mpisd.net
MPIUA	mpiua.com
MPLC	mplc.com
MPLC	mplc.org
MPORTAL	mportal.com
MPOWERMED	mpowermed.com
MPPC	mppc.org
MPR	mpr.com
MPR	mpr.org
MPREST	mprest.com
MPROVEN	mproven.com
MPS3D	mps3d.com
MPSEMINARS	mpseminars.com
MPTV	mptv.net
MQAD	mqad.com
MQUIQ	mquiq.com
MRAMCO	mramco.com
MRC3	mrc3.com
MRCA	mrca.org
MRCOSTUMES	mrcostumes.com
MREQUINE	mrequine.com
MRESULT	mresult.com
MRFIXED	mrfixed.com
MRIAUDIO	mriaudio.com
MRIGLOBAL	mriglobal.com
MRIGLOBALFOODBEV	mriglobalfoodbev.com
MRIGLOBALGOVCON	mriglobalgovcon.com
MRIGLOBALHEALTHCAREFINANCE	mriglobalhealthcarefinance.com
MRIGLOBALMEDDEVICE	mriglobalmeddevice.com
MRIGLOBALPLASTICS	mriglobalplastics.com
MRIGLOBALSCIENTIFIC	mriglobalscientific.com
MRIGLOBALSEARCH	mriglobalsearch.com
MRINETWORK	mrinetwork.com
MRINSTALLIT	mrinstallit.com
MRIS	mris.com
MRKED	mrked.com
MRKGRAPHICS	mrkgraphics.com
MRMASTERONLINE	mrmasteronline.com
MROADS	mroads.com
MROPA	mropa.com
MRSC	mrsc.org
MRTINSIGHTS	mrtinsights.com
MRV	mrv.com
MRWPCA	mrwpca.com
MSBCOACH	msbcoach.com
MSBO	msbo.org
MSCAA	mscaa.com
MSCBA	mscba.org
MSCCN	msccn.org
MSCD	mscd.edu
MSCI	msci.com
MSCSA	mscsa.org
MSCSOFTWARE	mscsoftware.com
MSDI	msdi.com
MSDSONLINE	msdsonline.com
MSDSPRO	msdspro.com
MSEDP	msedp.com
MSFC	msfc.com
MSGENUITY	msgenuity.com
MSGPR	msgpr.com
MSHOPPER	mshopper.com
MSIA	msia.org
MSIC	msic.org
MSISI	msisi.com
MSKCC	mskcc.org
MSKVIDEO	mskvideo.net
MSLLP	msllp.com
MSM	msm.edu
MSMSAVANNAH	msmsavannah.com
MSNAP	msnap.com
MSNBC	msnbc.com
MSO	mso.com
MSOCIALH	msocialh.com
MSOE	msoe.edu
MSPALLIANCE	mspalliance.com
MSPCA	mspca.org
MSPP	mspp.edu
MSPROJECTEXPERTS	msprojectexperts.com
MSPX	mspx.com
MSSMEDIA	mssmedia.com
MSSU	mssu.edu
MSTN	mstn.biz
MSU	msu.edu
MSUBILLINGS	msubillings.edu
MSUGF	msugf.edu
MT	mt.com
MT4MD	mt4md.com
MTA360	mta360.com
MTACC	mtacc.net
MTB	mtb.com
MTCI	mtci.com
MTCO	mtco.com
MTDS	mtds.com
MTECHNOLOGY	mtechnology.net
MTEMC	mtemc.com
MTEMS	mtems.com
MTF	mtf.org
MTHFITNESS	mthfitness.com
MTIAMERICA	mtiamerica.com
MTIELECTRONICS	mtielectronics.com
MTIPWORKS	mtipworks.com
MTM	mtm.com
MTMNET	mtmnet.com
MTN	mtn.com
MTN18	mtn18.com
MTNAPPROACH	mtnapproach.com
WAAV	waav.com
WABTEC	wabtec.com
WACA	waca.com
WACHA	wacha.org
WACHOVIA	wachovia.com
WACHUSETT	wachusett.com
WACKENHUT	wackenhut.com
WACKER	wacker.com
WACLLC	wacllc.com
WACMM	wacmm.org
WACOG	wacog.com
WAD	wad.cat
WADEWARE	wadeware.net
WAEGENER	waegener.com
WAEPA	waepa.org
WAFB	wafb.com
WAFERGEN	wafergen.com
WAFERNET	wafernet.com
WAFERTECH	wafertech.com
WAFF	waff.com
WAFFIL	waffil.com
WAFT	waft.org
WAFUNIF	wafunif.com
WAGAMAMA	wagamama.com
WAGBIZ	wagbiz.com
WAGEWORKS	wageworks.com
WAGGLEFORCE	waggleforce.com
WAGGLEZ	wagglez.com
WAGMAN	wagman.com
TODACELL	todacell.com
TODAYTIX	todaytix.com
TODOBEBE	todobebe.com
TOEMPLOY	toemploy.com
TOESOX	toesox.com
TOETAG	toetag.biz
TOETAPZ	toetapz.com
TOFUGU	tofugu.com
TOGETHERFARM	togetherfarm.com
TOGETHERINFITNESS	togetherinfitness.com
TOGORUN	togorun.com
TOGUH	toguh.com
TOIDELOI	toideloi.com
TOK3N	tok3n.com
TOKAYSEO	tokayseo.com
TOKENADS	tokenads.com
TOKENECONOMY	tokeneconomy.com
TOLEDOCLINIC	toledoclinic.com
TOLIBERTY	toliberty.com
TOLLESON	tolleson.com
TOLLIMO	tollimo.com
TOLMAR	tolmar.com
TOLOMATIC	tolomatic.com
TOLTEQ	tolteq.com
TOMATILLOS	tomatillos.com
TOMBERLIN	tomberlin.net
TOMCAR	tomcar.com
TOMGEEKERY	tomgeekery.com
TOMMIEMEDIA	tommiemedia.com
TOMNOD	tomnod.com
TOMODOM	tomodom.com
TOMOTECHI	tomotechi.com
TOMOTHERAPY	tomotherapy.com
TOMPCO	tompco.com
TOMTOM	tomtom.com
TONEFARMER	tonefarmer.net
TONEMEDIA	tonemedia.com
TONERBOSS	tonerboss.com
TONERIZE	tonerize.com
TONETECH	tonetech.com
TONEX	tonex.com
TONGAL	tongal.com
TONIAN	tonian.com
TONICARR	tonicarr.com
TONIIQ	toniiq.com
TONKIN	tonkin.com
TONX	tonx.org
TOOBLA	toobla.com
TOOCHT	toocht.com
TOODLESSKIN	toodlesskin.com
TOOLFARM	toolfarm.com
TOOLFETCH	toolfetch.com
TOOLINGDOCS	toolingdocs.com
TOOLMONKS	toolmonks.com
TOOLPRO	toolpro.com
TOOLS4EVER	tools4ever.com
TOOLSGROUP	toolsgroup.com
TOOLWATCH	toolwatch.com
TOOLWORKS	toolworks.org
TOOLWORX	toolworx.com
TOONIMO	toonimo.com
TOONUPS	toonups.com
TOOTSIES	tootsies.com
TOP3DENTISTS	top3dentists.com
TOPCODER	topcoder.com
TOPDEQ	topdeq.biz
TOPFLIGHT	topflight.com
TOPFLOORSTUDIO	topfloorstudio.com
TOPGUEST	topguest.com
TOPIFY	topify.com
TOPKATZ	topkatz.net
TOPOCEAN	topocean.com
TOPOLEWSKI	topolewski.net
TOPOPPS	topopps.com
TOPOTARGET	topotarget.com
TOPPATCH	toppatch.com
TOPPINGTHEWEB	toppingtheweb.com
TOPPS	topps.com
TOPQUADRANT	topquadrant.com
TOPROMOTE	topromote.com
TOPSOX	topsox.com
TOPSTEPTRADER	topsteptrader.com
TOPSVILLE	topsville.com
TOPSY	topsy.com
TOPWEBSITEPLACEMENT	topwebsiteplacement.com
TOR3Y	tor3y.com
TORA	tora.com
TORADEX	toradex.com
TORANI	torani.com
TORCHMATE	torchmate.com
TORCHWERKS	torchwerks.com
TORCHX	torchx.com
TORCON	torcon.com
TORGSYN	torgsyn.com
TORLEX	torlex.com
TORLYS	torlys.com
TORMACH	tormach.com
TORO	toro.com
TORPAL	torpal.com
TORPHOTO	torphoto.com
TORQWORKS	torqworks.com
TORRANCELEARNING	torrancelearning.com
TORRCO	torrco.com
TORREYPOINT	torreypoint.com
TORRID	torrid.com
TORRMETAL	torrmetal.com
TOSPT	tospt.com
TOSSOME	tossome.com
TOTAL	total.com
TOTALAMBER	totalamber.com
TOTALBANK	totalbank.com
TOTALCAREIT	totalcareit.com
TOTALNANNIES	totalnannies.com
TOTALOGISTIX	totalogistix.com
TOTALPAAS	totalpaas.com
TOTALPRINT	totalprint.com
TOTALTOYS	totaltoys.biz
TOTALWORKS	totalworks.net
TOTEVISION	totevision.com
TOTINETTE	totinette.com
TOTOKAELO	totokaelo.com
TOTOTOTOY	totototoy.com
TOTS2TWEENS	tots2tweens.com
TOTSPOT	totspot.com
TOTSY	totsy.com
TOTTINI	tottini.com
TOTUSTECH	totustech.com
TOTVS	totvs.com
TOUCHACTIONAPPS	touchactionapps.com
TOUCHBISTRO	touchbistro.com
TOUCHBLOCK	touchblock.com
TOUCHCAST	touchcast.com
TOUCHCOMMERCE	touchcommerce.com
TOUCHCONCEPT	touchconcept.com
TOUCHDOWNSPACE	touchdownspace.com
TOUCHFACTOR	touchfactor.com
TOUCHFASTER	touchfaster.com
TOUCHFIRST	touchfirst.com
TOUCHGEN	touchgen.com
TOUCHINGHEARTSTHROUGHATHLETICS	touchingheartsthroughathletics.org
TOUCHMARK	touchmark.com
TOUCHMD	touchmd.com
TOUCHMEDIAUSA	touchmediausa.com
TOUCHNET	touchnet.com
TOUCHPOLL	touchpoll.com
TOUCHPRO	touchpro.com
TOUCHRATE	touchrate.com
TOUCHSTORM	touchstorm.com
TOUCHSYSTEMS	touchsystems.com
TOUCHTUNES	touchtunes.com
TOUCHVISION	touchvision.com
TOUCOMMUNICATIONS	toucommunications.com
TOUFAYAN	toufayan.com
TOUGHBUILT	toughbuilt.com
TOUGHLOVE	toughlove.com
TOURCOACH	tourcoach.com
TOURCONNECT	tourconnect.com
TOURFACTORY	tourfactory.com
TOURISTLINK	touristlink.com
TOURKIDD	tourkidd.com
TOURMATTERS	tourmatters.com
TOURNEAU	tourneau.com
TOURS4FUN	tours4fun.com
TOURVATION	tourvation.com
TOUS	tous.com
TOUSIMIS	tousimis.com
TOUT	tout.com
TOWERCO	towerco.com
TOWERDATA	towerdata.com
TOWERMETRIX	towermetrix.com
TOWERPINKSTER	towerpinkster.com
TOWERSTREAM	towerstream.com
TOWERWALL	towerwall.com
TOWLEROAD	towleroad.com
TOWNCENTER	towncenter.com
TOWNEBANK	townebank.net
TOWNESCAPES	townescapes.net
TOWNHOG	townhog.com
TOWNLEY	townley.net
TOWNSPEOPLE	townspeople.org
TOWSLEYS	towsleys.com
TOWSON	towson.edu
TOWSONGLOBAL	towsonglobal.com
TOXCEL	toxcel.com
TOXIKON	toxikon.com
TOXSTRATEGIES	toxstrategies.com
TOYCHASERS	toychasers.com
TOYJOBS	toyjobs.com
TOYJUNKIES	toyjunkies.com
TOYOPOLIS	toyopolis.com
TOYOTA	toyota.com
TOYQUEST	toyquest.com
TOYSMITH	toysmith.com
TOYSRUS	toysrus.com
TOYWIZ	toywiz.com
TPACC	tpacc.com
TPCBC	tpcbc.org
TPCIGA	tpciga.org
TPCOMPLIANCE	tpcompliance.com
TPI	tpi.net
TPM	tpm.com
TPMHMR	tpmhmr.org
TPSR	tpsr.com
TPT	tpt.com
TQL	tql.com
TRAACKR	traackr.com
TRAANSMISSION	traansmission.com
MARTAN	martan.com
MARTEK	martek.com
MARTHAPIX	marthapix.com
MARTIFER	martifer.com
MARTINAIRE	martinaire.com
MARTINEZARTZ	martinezartz.com
MARTINFILMS	martinfilms.com
MARTINLOGAN	martinlogan.com
MARTINSCOTTVO	martinscottvo.com
MARTIVISION	martivision.com
MARTOPIA	martopia.com
MARUMBA	marumba.com
MARVAIR	marvair.com
MARVELASOL	marvelasol.com
MARVELL	marvell.com
MARVINS	marvins.com
MARWEN	marwen.org
MARYE-KELLEY	marye-kelley.com
MARYHAVEN	maryhaven.com
MARYJANESFARM	maryjanesfarm.org
MARYKNOLL	maryknoll.org
MARYMELLOWTEAS	marymellowteas.com
MARYMOUNT	marymount.edu
MARYTOWN	marytown.com
MARYVALE	maryvale.org
MASCOAT	mascoat.com
MASCOBATH	mascobath.com
MASCON	mascon.com
MASCULINITYU	masculinityu.com
MASERGY	masergy.com
MASHALOT	mashalot.com
MASHAPE	mashape.com
MASHBURNSACKETT	mashburnsackett.com
MASHERY	mashery.com
MASHON	mashon.com
MASHPOINT	mashpoint.com
MASIJC	masijc.org
MASIMEX	masimex.com
MASIMO	masimo.com
MASINS	masins.com
MASON	mason.biz
MASONEILAN	masoneilan.com
MASONICARE	masonicare.org
MASONITE	masonite.com
MASONLANE	masonlane.com
MASPIRE	maspire.com
MASSACCESS	massaccess.org
MASSADA	massada.com
MASSAGE4ALL	massage4all.com
MASSAGEBOOK	massagebook.com
MASSAGEBYMIMI	massagebymimi.com
MASSAGELUXE	massageluxe.com
MASSANOIS	massanois.com
MASSAV	massav.com
MASSBID	massbid.net
MASSBIKE	massbike.org
MASSBIO	massbio.org
MASSBIOLOGICS	massbiologics.org
MASSBITS	massbits.com
MASSCARE	masscare.org
MASSCATALYST	masscatalyst.com
MASSCREATIVE	masscreative.org
MASSDEVELOPMENT	massdevelopment.com
MASSDEVICE	massdevice.com
MASSDIGI	massdigi.org
MASSDRIVE	massdrive.com
MASSDROP	massdrop.com
MASSECON	massecon.com
MASSEQUALITY	massequality.org
MASSFINITY	massfinity.com
MASSHOMES	masshomes.com
MASSHOUSING	masshousing.com
MASSINNOVATION	massinnovation.com
MASSIVEIMPACT	massiveimpact.com
MASSIVELY	massively.com
MASSIVEMUSIC	massivemusic.com
MASSLOGICS	masslogics.com
MASSMOUTH	massmouth.org
MASSMUTUAL	massmutual.com
MASSOLUTIONS	massolutions.biz
MASSPAY	masspay.net
MASSPORT	massport.com
MASSPRO	masspro.org
MASSRECYCLE	massrecycle.org
MASSRESISTANCE	massresistance.org
MASSTHINK	massthink.com
MASSVOTE	massvote.org
MASTEC	mastec.com
MASTECH	mastech.com
MASTERCABLE	mastercable.net
MASTERCARD	mastercard.com
MASTERCRAFT-LAMPS	mastercraft-lamps.com
MASTERCRUITS	mastercruits.com
MASTERDISK	masterdisk.com
MASTERDRIVE	masterdrive.com
MASTERFILES	masterfiles.com
MASTERGRAPHICS	mastergraphics.com
MASTERIT	masterit.com
MASTERKLEEN	masterkleen.com
MASTERLUBE	masterlube.com
MASTERMARK	mastermark.net
MASTERPHARM	masterpharm.com
MASTERPHONIC	masterphonic.com
MASTERPLANS	masterplans.com
MASTERSCOACHING	masterscoaching.com
MASTERSFX	mastersfx.com
MASTERSTREET	masterstreet.com
MASTERSYSTEM	mastersystem.com
MASTERTAG	mastertag.com
MASTERTRADER	mastertrader.com
MASTERWORKS	masterworks.com
MASTERYCONNECT	masteryconnect.com
MASTHINK	masthink.com
MASTHOF	masthof.com
MASTIP	mastip.com
MASTRAPASQUA	mastrapasqua.com
MASTRY	mastry.com
MASWARE	masware.net
MATAANO	mataano.com
MATC	matc.edu
MATCHBIN	matchbin.com
MATCHCRAFT	matchcraft.com
MATCHEDMARKETING	matchedmarketing.com
MATCHEDMEDIA	matchedmedia.com
MATCHNODE	matchnode.com
MATCHPOINT	matchpoint.com
MATCHRX	matchrx.com
MATCHSTIC	matchstic.com
MATEC	matec.com
MATEREALITY	matereality.com
MATERIALOGIC	materialogic.com
MATERNOHIO	maternohio.com
MATERNOVA	maternova.net
MATHCOUNTS	mathcounts.org
MATHISENMEDIA	mathisenmedia.com
MATHISONS	mathisons.com
MATHMARKETING	mathmarketing.com
MATHMOOSE	mathmoose.com
MATHNASIUM	mathnasium.com
MATHODES	mathodes.com
MATHSTATIC	mathstatic.com
MATHSTRUC	mathstruc.com
MATHWORKS	mathworks.com
MATICLINE	maticline.com
MATINC	matinc.net
MATLINPATTERSON	matlinpatterson.com
MATMARKET	matmarket.com
MATMON	matmon.com
MATRADEE	matradee.com
MATRICAL	matrical.com
MATRINMD	matrinmd.com
MATRIX42	matrix42.com
MATRIXFORCE	matrixforce.com
MATRIXPOINTE	matrixpointe.com
MATSCO	matsco.com
MATSON	matson.com
MATTEK	mattek.com
MATTEL	mattel.com
MATTERFACTURE	matterfacture.com
MATTERPORT	matterport.com
MATTISONWEB	mattisonweb.com
MATTOGRAPHIC	mattographic.com
MATTSLENS	mattslens.com
MATTSON	mattson.com
MATURECLOUD	maturecloud.com
MAU	mau.com
MAUBOUSSIN	mauboussin.com
MAUDAU	maudau.com
MAURICES	maurices.com
MAUROMEDIA	mauromedia.com
MAURONEWMEDIA	mauronewmedia.com
MAV12	mav12.com
MAV6	mav6.com
MAVA	mava.org
MAVCO	mavco.com
MAVENIR	mavenir.com
MAVENLINK	mavenlink.com
MAVENSPIRE	mavenspire.com
MAVENT	mavent.com
MAVENWIRE	mavenwire.com
MAVERIK	maverik.com
MAVERON	maveron.com
UMDF	umdf.org
UMDNJ	umdnj.edu
UMEDEX	umedex.com
UMENTIONED	umentioned.com
UMES	umes.edu
UMEVOICE	umevoice.com
UMFS	umfs.org
UMHB	umhb.edu
UMICH	umich.edu
UMICORE	umicore.com
UMKC	umkc.edu
UMLOUD	umloud.org
UMMHC	ummhc.org
UMNC	umnc.org
UMNIAH	umniah.com
UMOJO	umojo.com
UMONITOR	umonitor.com
UMOS	umos.org
UMOVEFREE	umovefree.com
UMR	umr.com
UMSL	umsl.edu
UMT	umt.com
TRACE3	trace3.com
TRACELINK	tracelink.com
TRACERCO	tracerco.com
TRACERISK	tracerisk.com
TRACESECURITY	tracesecurity.com
TRACFONE	tracfone.com
TRACK180	track180.com
TRACK5MEDIA	track5media.com
TRACKAIR	trackair.com
TRACKBILL	trackbill.com
TRACKCRAFTERS	trackcrafters.com
TRACKDAZ	trackdaz.com
TRACKMASTER	trackmaster.com
TRACKMAVEN	trackmaven.com
TRACKMAX	trackmax.com
TRACKMOBILE	trackmobile.com
TRACKSMITH	tracksmith.com
TRACKSNTEETH	tracksnteeth.com
TRACKUR	trackur.com
TRACNCARE	tracncare.com
TRACO	traco.com
TRACORP	tracorp.biz
TRACORP	tracorp.com
TRACPOINT	tracpoint.com
TRACSOFT	tracsoft.com
TRACSYSTEMS	tracsystems.com
TRACTORHOUSE	tractorhouse.com
TRACX	tracx.com
TRACYLOCKE	tracylocke.com
TRADAVO	tradavo.com
TRADE2SAVE	trade2save.com
TRADEBANK	tradebank.com
TRADEBEAM	tradebeam.com
TRADEBLOCK	tradeblock.com
TRADEDOUBLER	tradedoubler.com
TRADEHILL	tradehill.com
TRADEKING	tradeking.com
TRADEMARKIA	trademarkia.com
TRADEMAVEN	trademaven.com
TRADEMOTION	trademotion.com
TRADEPAQ	tradepaq.com
TRADEPMR	tradepmr.com
TRADEPULSE	tradepulse.com
TRADEREV	traderev.com
TRADERFY	traderfy.com
TRADESCAPE	tradescape.biz
TRADESHOWDIRECT	tradeshowdirect.com
TRADESHOWLOGISTICS	tradeshowlogistics.com
TRADESOURCE	tradesource.com
TRADESTATION	tradestation.com
TRADESY	tradesy.com
TRADESYNC	tradesync.com
TRADETHENEWS	tradethenews.com
TRADEVERSITY	tradeversity.com
TRADEWARE	tradeware.com
TRADEWEB	tradeweb.com
TRADEWORX	tradeworx.com
TRADEWRAPS	tradewraps.com
TRADIEN	tradien.com
TRADIER	tradier.com
TRADINGPARTNERS	tradingpartners.com
TRADINGPUB	tradingpub.com
TRADINGSCREEN	tradingscreen.com
TRADIOV	tradiov.com
TRAEMAND	traemand.com
TRAFALGAR	trafalgar.com
TRAFFICATTRACT	trafficattract.com
TRAFFICCAST	trafficcast.com
TRAFFICDEVELOPER	trafficdeveloper.com
TRAFFICLAND	trafficland.com
TRAFFICLEADS2INCOME	trafficleads2income.com
TRAFFICONSULT	trafficonsult.com
TRAFFICPAYMENT	trafficpayment.com
TRAFFICPRM	trafficprm.com
TRAFFICWARE	trafficware.com
TRAFFICWAVE	trafficwave.net
TRAFFICZ	trafficz.com
TRAFFICZOOM	trafficzoom.com
TRAFFIQ	traffiq.com
TRAFIKADS	trafikads.com
TRAFIXS	trafixs.com
TRAIANA	traiana.com
TRAILHEADS	trailheads.com
TRAILLWORKS	traillworks.com
TRAILMATE	trailmate.com
TRAILNET	trailnet.org
TRAILTALKS	trailtalks.org
TRAINACE	trainace.com
TRAINERSVAULT	trainersvault.com
TRAINERTAINMENT	trainertainment.net
TRAINEVISION	trainevision.com
TRAINFOUR	trainfour.com
TRAINHEROIC	trainheroic.com
TRAININGABC	trainingabc.com
TRAININGFOLKS	trainingfolks.com
TRAININGMINDS	trainingminds.com
TRAININGPEAKS	trainingpeaks.com
TRAININGPRO	trainingpro.com
TRAININGRITE	trainingrite.com
TRAINZ	trainz.com
TRAITMARKER	traitmarker.com
TRAKAMERICA	trakamerica.com
TRAKBILL	trakbill.com
TRAKUS	trakus.com
TRALIANCE	traliance.com
TRAMS	trams.com
TRANDOTCOM	trandotcom.com
TRANE	trane.com
TRANONT	tranont.com
TRANPAK	tranpak.com
TRANS-OVERSEAS	trans-overseas.com
TRANSACCESS	transaccess.org
TRANSACCT	transacct.com
TRANSACTEL	transactel.net
TRANSACTIS	transactis.com
TRANSACTPOS	transactpos.com
TRANSACTRX	transactrx.com
TRANSALTA	transalta.com
TRANSAMERICA	transamerica.com
TRANSAMMONIA	transammonia.com
TRANSARRAY	transarray.com
TRANSATEL	transatel.com
TRANSAVIA	transavia.com
TRANSAXLE	transaxle.com
TRANSBEAM	transbeam.com
TRANSCARD	transcard.com
TRANSCARE	transcare.com
TRANSCARVECA	transcarveca.com
TRANSCAT	transcat.com
TRANSCELERATE	transcelerate.com
TRANSCENDE	transcende.net
TRANSCENDENTIST	transcendentist.com
TRANSCENSUS	transcensus.com
TRANSCEPTA	transcepta.com
TRANSCERTAIN	transcertain.com
TRANSCHART	transchart.org
TRANSCIRRUS	transcirrus.com
TRANSCORE	transcore.com
TRANSCORR	transcorr.com
TRANSCRIBEME	transcribeme.com
TRANSCRIPTIC	transcriptic.com
TRANSCRIPTIONMAX	transcriptionmax.com
TRANSCRIPTIONSTAR	transcriptionstar.com
TRANSDYN	transdyn.com
TRANSEARCH	transearch.com
TRANSECH	transech.com
TRANSENDA	transenda.com
TRANSENTERIX	transenterix.com
TRANSERVICE	transervice.com
TRANSFERTO	transferto.com
TRANSFINDER	transfinder.com
TRANSFIRST	transfirst.com
TRANSFIRST	transfirst.net
TRANSFLUENCI	transfluenci.com
TRANSFLUENT	transfluent.com
TRANSFOLIOS	transfolios.com
TRANSFORCE	transforce.com
TRANSFORMAGIC	transformagic.com
TRANSFORMATECH	transformatech.com
TRANSFORMATIVEMED	transformativemed.com
TRANSFORMED	transformed.com
TRANSFORMHEALTHRX	transformhealthrx.com
TRANSFORMIT	transformit.com
TRANSFORMROCKFORD	transformrockford.org
TRANSFORMSOLAR	transformsolar.com
TRANSFORMU	transformu.com
TRANSFREIGHT	transfreight.com
TRANSFURTER	transfurter.com
TRANSGUARDIAN	transguardian.com
TRANSHARE	transhare.com
TRANSHINE	transhine.com
TRANSHOTEL	transhotel.com
TRANSIFEX	transifex.com
TRANSILWRAP	transilwrap.com
TRANSITIONGUIDES	transitionguides.com
TRANSITIONS	transitions.com
TRANSITIONS	transitions.pro
TRANSITIONSPOT	transitionspot.com
TRANSITOWNEUSA	transitowneusa.com
TRANSITRONIX	transitronix.com
TRANSLANGCO	translangco.com
TRANSLAT	translat.biz
TRANSLATEMEDIA	translatemedia.com
TRANSLATIONLINKS	translationlinks.com
TRANSLATUS	translatus.com
TRANSLIA	translia.com
TRANSLIZER	translizer.com
TRANSLOC	transloc.com
TRANSLUME	translume.com
TRANSMAGIC	transmagic.com
TRANSMERSIVE	transmersive.com
TRANSMITIVE	transmitive.com
TRANSMODAL	transmodal.net
TRANSMODUS	transmodus.net
TRANSMOGRAPHIC	transmographic.com
TRANSMONTAIGNE	transmontaigne.com
TRANSMUTO	transmuto.com
TRANSNAV	transnav.com
TRANSOFT	transoft.com
TRANSORT	transort.net
TRANSOURCE	transource.com
TRANSPAK	transpak.com
TRANSPARATECH	transparatech.com
TRANSPARENTCONTAINER	transparentcontainer.com
TRANSPARENTRX	transparentrx.com
TRANSPECOSFOODS	transpecosfoods.com
TRANSPERFECT	transperfect.com
TRANSPIRUS	transpirus.com
TRANSPLACE	transplace.com
TRANSPOINT	transpoint.com
TRANSPOREON	transporeon.com
TRANSPORT4	transport4.com
TRANSPORTECH	transportech.com
TRANSROCKIES	transrockies.com
TRANSTECHS	transtechs.com
TRANSTELCO	transtelco.com
TRANSTYLE	transtyle.com
TRANSUNION	transunion.com
TRANSVERSAL	transversal.com
TRANSVOYANT	transvoyant.com
TRANSWALL	transwall.com
TRANSWARE	transware.com
TRANSWEST	transwest.com
TRANSWESTERN	transwestern.net
TRANSWIDE	transwide.com
TRANSWOOD	transwood.com
TRANSX	transx.com
TRANSYSTEMS	transystems.com
TRANTER	tranter.com
TRANXITION	tranxition.com
TRANZACT	tranzact.net
TRANZAMERICA	tranzamerica.net
TRANZISHEN	tranzishen.com
TRANZLOGIC	tranzlogic.com
TRANZON	tranzon.com
TRANZXL	tranzxl.com
TRAPAC	trapac.com
TRAPEZIO	trapezio.com
TRAPOLLO	trapollo.com
TRASKBRITT	traskbritt.com
TRASYS	trasys.com
TRATERRA	traterra.com
TRAVALLIANCEMEDIA	travalliancemedia.com
TRAVALO	travalo.com
TRAVCOA	travcoa.com
TRAVEK	travek.com
TRAVEK	travek.net
TRAVEL2CHANGE	travel2change.org
TRAVELADVOCATES	traveladvocates.com
TRAVELATT	travelatt.com
TRAVELBRAINS	travelbrains.com
TRAVELBROKERS	travelbrokers.com
TRAVELCLICK	travelclick.com
TRAVELCLICK	travelclick.net
TRAVELCOPIA	travelcopia.com
TRAVELEADERS	traveleaders.com
TRAVELENERGY	travelenergy.net
TRAVELERS	travelers.com
TRAVELFIT	travelfit.biz
TRAVELFOCUS	travelfocus.com
TRAVELINE	traveline.com
UMTHUNZI	umthunzi.com
UMTR2ME	umtr2me.org
UMUC	umuc.edu
UMZUZU	umzuzu.com
UN	un.org
UNALAM	unalam.com
UNALISYS	unalisys.com
UNANET	unanet.com
UNAPEN	unapen.com
UNATION	unation.com
UNAVCO	unavco.org
UNAVERRA	unaverra.com
UNBABEL	unbabel.com
UNBOGGLEIT	unboggleit.com
UNBOUNDARY	unboundary.com
UNBRAKO	unbrako.com
UNBREAKABLEIT	unbreakableit.com
UNBREAKMOBILE	unbreakmobile.com
UNC	unc.edu
UNCC	uncc.edu
UNCFSP	uncfsp.org
UNCG	uncg.edu
UNCOLLEGE	uncollege.org
UNCOMMONGOODS	uncommongoods.com
UNCP	uncp.edu
UNCTAD	unctad.org
UNCTV	unctv.org
UNCW	uncw.edu
UNDABO	undabo.com
UNDC	undc.com
UNDERARMOUR	underarmour.com
UNDERCITY	undercity.org
UNDERCURRENT	undercurrent.com
UNDERGROUNDAV	undergroundav.com
UNDERSTOOD	understood.com
UNDERTONE	undertone.com
UNDORM	undorm.com
UNDOSTRIAL	undostrial.com
UNDP	undp.org
UNEDOLLAR	unedollar.com
UNELKO	unelko.com
UNEMED	unemed.com
UNETEK	unetek.com
UNETTE	unette.com
UNEVENLANE	unevenlane.com
UNF	unf.edu
UNFCCC	unfccc.int
UNFI	unfi.com
UNFINISHED	unfinished.com
UNFINITI	unfiniti.com
UNFPA	unfpa.org
UNFRIENDLYGHOST	unfriendlyghost.com
UNH	unh.edu
UNI-TEK	uni-tek.com
UNI	uni.edu
UNIBANK	unibank.com
UNIBRAZE	unibraze.com
UNICA	unica.com
UNICEF	unicef.org
UNICEL	unicel.com
UNICITY	unicity.net
UNICOMM	unicomm.org
UNICON	unicon.net
UNICORNHRO	unicornhro.com
UNICOURT	unicourt.com
UNICQ	unicq.net
UNIDADA	unidada.com
UNIDEC	unidec.com
UNIDEN	uniden.com
UNIDO	unido.org
UNIEROS	unieros.com
UNIFEEDER	unifeeder.com
UNIFI	unifi.com
UNIFIED360	unified360.com
UNIFIEDDIRECT	unifieddirect.net
UNIFIEDNOISE	unifiednoise.com
UNIFIN	unifin.com
UNIFIRST	unifirst.com
UNIFLOCKAGE	uniflockage.com
UNIFOCUS	unifocus.com
UNIFORM	uniform.net
UNIFRAX	unifrax.com
UNIFUND	unifund.com
UNIFY	unify.com
UNIFYCLOUD	unifycloud.com
UNIFYHR	unifyhr.com
UNIFYZE	unifyze.com
UNIGENE	unigene.com
UNIGUEST	uniguest.com
UNILABEXPRESS	unilabexpress.com
UNILABS	unilabs.com
UNILEVER	unilever.com
UNILINK	unilink.com
UNILOCK	unilock.com
UNIMAR	unimar.com
UNIMARKET	unimarket.com
UNIMAX	unimax.com
UNIMERCO	unimerco.com
UNIMICRON	unimicron.com
UNIMUNDOTV	unimundotv.com
UNIONSQUARE456	unionsquare456.com
UNIONWEAR	unionwear.com
UNIPHARMA	unipharma.org
UNIPLAN	uniplan.com
UNIPROP	uniprop.com
UNIPROSERVICES	uniproservices.com
UNIPURE	unipure.com
UNIQUE3DDIGITAL	unique3ddigital.com
UNIQUEACTIVE	uniqueactive.com
UNIQUEHR	uniquehr.com
UNIQUESOFT	uniquesoft.com
UNIQUEST	uniquest.com
UNIRELO	unirelo.com
UNIREX	unirex.net
UNIRISX	unirisx.com
UNISEA	unisea.com
UNISFAIR	unisfair.com
UNISHIPPERS	unishippers.com
UNISIG	unisig.com
UNISIGHT	unisight.net
UNISLAT	unislat.com
UNISNACKS	unisnacks.com
UNISPACE	unispace.com
UNISYS	unisys.com
UNIT5	unit5.org
UNIT9	unit9.com
UNITASK	unitask.com
UNITED	united.com
UNITED4IRAN	united4iran.org
UNITEDAMS	unitedams.com
UNITEDCENTER	unitedcenter.com
UNITEDLAYER	unitedlayer.com
UNITEDLEX	unitedlex.com
UNITEDLTC	unitedltc.com
UNITEDWEB	unitedweb.com
UNITEHERE	unitehere.org
UNITELLER	uniteller.com
UNITHERM	unitherm.com
UNITIL	unitil.com
UNITIV	unitiv.com
UNITOURS	unitours.com
UNITRENDS	unitrends.com
UNITRON	unitron.com
UNITY	unity.org
UNITYECM	unityecm.com
UNITYI	unityi.com
UNIVAL	univali.br
UNIVAR	univar.com
UNIVEG	univeg.com
UNIVENTURE	univenture.com
UNIVERA	univera.com
UNIVERSA	universa.net
UNIVERSALCULTURE	universalculture.com
UNIVERSALGIVING	universalgiving.org
UNIVERSALMAC	universalmac.com
UNIVERSITYPARENT	universityparent.com
UNIVESCO	univesco.com
UNIVEST	univest.net
UNIVFY	univfy.com
UNIVISION	univision.net
UNIVISTA	univista.com
UNIVOIP	univoip.com
UNIWIGS	uniwigs.com
UNIWORLD	uniworld.com
UNIX2K	unix2k.com
UNIXFOR	unixfor.com
UNKASOFT	unkasoft.com
UNKNOWNED	unknowned.org
UNKNOWNVARIABLES	unknownvariables.com
UNL	unl.edu
UNLIMISOFT	unlimisoft.com
UNLOCKABLE	unlockable.com
UNLV	unlv.edu
UNM	unm.edu
UNMC	unmc.edu
UNOMEDICAL	unomedical.com
UNOMY	unomy.com
UNOS	unos.org
UNOSQUARE	unosquare.com
UNOVOID	unovoid.com
UNOVON	unovon.com
UNOWHY	unowhy.com
UNOX	unox.com
UNPAKT	unpakt.com
UNPAQ	unpaq.com
UNQUANTUM	unquantum.net
UNR	unr.edu
UNREEL	unreel.com
UNRWA	unrwa.org
UNSIGNEDRTISTS	unsignedrtists.com
UNSTUDIO	unstudio.com
UNT	unt.edu
UNTANGLE	untangle.com
UNTAPPEDREP	untappedrep.com
UNTAPT	untapt.com
UNTATTOOU	untattoou.com
UNTELEPORTED	unteleported.com
UNTICORP	unticorp.com
UNUM	unum.com
UNVC	unvc.org
UNWINNABLE	unwinnable.com
UNYQ	unyq.com
UNYTEL	unytel.com
UOHA	uoha.com
UOP	uop.com
UOPEN	uopen.com
UOSA	uosa.org
UOWHO	uowho.com
UP2US	up2us.org
UPAL	upal.com
UPCITY	upcity.com
UPCLEAR	upclear.com
UPCYCLELIFE	upcyclelife.com
UPDATE	update.com
UPDATELOGIC	updatelogic.com
UPDAYTON	updayton.com
UPDENTITY	updentity.com
UPDESK	updesk.com
UPEK	upek.com
UPERBIDS	uperbids.com
UPF	upf.edu
UPGRADEJOURNEY	upgradejourney.com
UPHP	uphp.com
UPI	upi.org
UPIAN	upian.com
UPIQ	upiq.com
UPLANME	uplanme.com
UPLIFTED	uplifted.net
UPLINKSPYDER	uplinkspyder.com
UPLINX	uplinx.net
UPLOGIX	uplogix.com
UPLONE	uplone.com
UPLV	uplv.net
UPLYNK	uplynk.com
UPMC	upmc.edi
UPMC	upmc.edu
UPMO	upmo.com
UPNORTHVET	upnorthvet.com
UPOUT	upout.com
UPP	upp.net
UPPABABY	uppababy.com
UPPERQUAD	upperquad.com
UPPERSPACE	upperspace.com
UPPERSTRATA	upperstrata.com
UPROMISE	upromise.com
UPS-A-DAISY	ups-a-daisy.com
UPS-SCS	ups-scs.com
UPS	ups.com
UPSEARCH	upsearch.com
UPSHOT	upshot.net
UPSIDEOVER	upsideover.com
UPSOLUTE	upsolute.com
UPSTART	upstart.com
UPSTATEMENT	upstatement.com
UPSTRT	upstrt.com
UPSYNC	upsync.com
UPTACK	uptack.com
UPTHERE	upthere.com
UPTIVITY	uptivity.com
UPTO	upto.com
UPTODATE	uptodate.com
UPTOKE	uptoke.net
UPTOWNCOLOR	uptowncolor.com
UPTRACS	uptracs.com
UPTRENDING	uptrending.com
UPTWEET	uptweet.com
UPVERTER	upverter.com
UPWORTHY	upworthy.com
UQM	uqm.com
UR	ur.com
URAC	urac.org
URALITA	uralita.com
URBACS	urbacs.com
URBAN4M	urban4m.com
URBANADD	urbanadd.com
URBANADLAB	urbanadlab.com
URBANATA	urbanata.com
URBANBITE	urbanbite.com
URBANBOUND	urbanbound.com
URBANCASE	urbancase.com
URBANDADDY	urbandaddy.com
URBANEDU	urbanedu.org
URBANGIRL	urbangirl.com
URBANGLASS	urbanglass.org
URBANIZA	urbaniza.com
URBANLAB	urbanlab.com
URBANMARTINI	urbanmartini.com
URBANMINDSHARE	urbanmindshare.com
URBANOMICS	urbanomics.org
URBANRIDE	urbanride.com
URBANSAC	urbansac.com
URBANSITTER	urbansitter.com
URBANSTEAD	urbanstead.org
URBANSTITCHING	urbanstitching.com
URBANWELLNESS	urbanwellness.com
URBFUL	urbful.com
URBICAST	urbicast.com
URBIZSOLUTION	urbizsolution.com
URBNIX	urbnix.com
URBUU	urbuu.com
UREVEAL	ureveal.com
URFALIAN	urfalian.com
URGENTCAREGURU	urgentcareguru.com
URGENTRX	urgentrx.com
URI	uri.edu
URJ	urj.org
URLINQ	urlinq.com
URMIA	urmia.org
URMMA	urmma.org
UROLOGIX	urologix.com
UROMED	uromed.com
UROPLASTY	uroplasty.com
UROSA	urosa.com
URPANTECH	urpantech.com
URS	urs.org
URSANAV	ursanav.com
URTAXSOLUTIONS	urtaxsolutions.com
URTHECAST	urthecast.com
URUUT	uruut.com
URVANX	urvanx.com
TRINOOR	trinoor.com
TRINTECH	trintech.com
TRINTME	trintme.com
TRINTRONIX	trintronix.com
TRINWORDS	trinwords.com
TRIODENT	triodent.com
TRIODETIC	triodetic.com
TRIOLITE	triolite.com
TRIORGANICS	triorganics.com
TRIORIENT	triorient.com
TRIOSE	triose.com
TRIP30	trip30.com
TRIPACK	tripack.net
TRIPADVISOR	tripadvisor.com
TRIPANGLE	tripangle.com
TRIPANOMALY	tripanomaly.com
TRIPBNB	tripbnb.com
TRIPCASE	tripcase.com
TRIPCHI	tripchi.com
TRIPCRAFT	tripcraft.com
TRIPELATE	tripelate.com
TRIPFILMS	tripfilms.com
TRIPIL	tripil.com
TRIPLECURVE	triplecurve.com
TRIPLEDISC	tripledisc.com
TRIPLEDUBS	tripledubs.com
TRIPLEFIN	triplefin.com
TRIPLEINK	tripleink.com
TRIPLELENS	triplelens.com
TRIPLELIFT	triplelift.com
TRIPLEROI	tripleroi.com
TRIPLETREE	tripletree.com
TRIPLINGO	triplingo.com
TRIPOS	tripos.com
TRIPOWER	tripower.com
TRIPPER	tripper.com
TRIPPING	tripping.com
TRIPRACTIX	tripractix.com
TRIPSIDIZE	tripsidize.com
TRIPSTR	tripstr.com
TRIPTEL	triptel.com
TRIPTRACE	triptrace.com
TRIPTWIT	triptwit.com
TRIPWIRE	tripwire.com
TRIPZAAR	tripzaar.com
TRIPZERO	tripzero.com
TRIQUESTA	triquesta.com
TRIS3CT	tris3ct.com
TRISERA	trisera.com
TRISSENTIAL	trissential.com
TRISTAFF	tristaff.com
TRISTAR	tristar.com
TRISTATETELECOM	tristatetelecom.com
TRISURE	trisure.com
TRITATS	tritats.com
TRITEKK	tritekk.net
TRITONES	tritones.net
TRITONEXEC	tritonexec.com
TRITRILLION	tritrillion.com
TRIVACO	trivaco.com
TRIVAN	trivan.net
TRIVANI	trivani.org
TRIVANTIS	trivantis.com
TRIVANTUS	trivantus.com
TRIVIRIX	trivirix.com
TRIVITA	trivita.com
TRIVNET	trivnet.com
TRIWAYS	triways.com
TRIWEST	triwest.com
TRIWORTH	triworth.com
TRIXIRIA	trixiria.com
TRIYAR	triyar.com
TRIZCOM	trizcom.com
TRIZETTO	trizetto.com
TROCAIRE	trocaire.edu
TROCOMPSA	trocompsa.com
TROFIE	trofie.com
TROJANONE	trojanone.com
TROLLBACK	trollback.com
TROLLTECH	trolltech.com
TROMBETTA	trombetta.com
TRONITECH	tronitech.com
TRONOX	tronox.com
TROOPTO	troopto.com
TROOVIZION	troovizion.com
TROPICANA	tropicana.com
TROTTERART	trotterart.com
TROUTMANSANDERS	troutmansanders.com
TROUX	troux.com
TROVALI	trovali.com
TROVENA	trovena.com
TROVER	trover.com
TROVIZ	troviz.com
TROWEPRICE	troweprice.com
TROYCABLE	troycable.net
TROYGOULD	troygould.com
TROYSTAR	troystar.com
TRPB	trpb.com
TRPC	trpc.biz
TRS-RENTELCO	trs-rentelco.com
TRS-SESCO	trs-sesco.com
TRSA	trsa.org
TRUACUITY	truacuity.com
TRUARX	truarx.com
TRUAUDIO	truaudio.com
TRUBRAIN	trubrain.com
TRUBRIDGE	trubridge.net
TRUCCHIS	trucchis.com
TRUCHOCOLATE	truchocolate.com
TRUCKAST	truckast.com
TRUCKERSB2B	truckersb2b.com
TRUCKINGOFFICE	truckingoffice.com
TRUCKIT365	truckit365.com
TRUCKITNOW	truckitnow.com
TRUCKMOVERS	truckmovers.com
TRUCKNATION	trucknation.net
TRUCKPRO	truckpro.com
TRUCKSKIN	truckskin.com
TRUCKVAULT	truckvault.com
TRUCLINIC	truclinic.com
TRUCODE	trucode.com
TRUDENTA	trudenta.com
TRUEABILITY	trueability.com
TRUEART	trueart.biz
TRUECHILD	truechild.org
TRUECLOUD	truecloud.com
TRUEDESIGNS	truedesigns.net
TRUEFFECT	trueffect.com
TRUEFIRE	truefire.com
TRUEFORCE	trueforce.com
TRUEITPROS	trueitpros.com
TRUELANGUAGE	truelanguage.com
TRUELIFT	truelift.org
TRUELINE	trueline.net
TRUELOOK	truelook.com
TRUEMATTER	truematter.com
TRUEMETHODS	truemethods.com
TRUEMETRICS	truemetrics.net
TRUEMRI	truemri.com
TRUENORTHLOGIC	truenorthlogic.com
TRUEPANEL	truepanel.com
TRUEPATHMARKET	truepathmarket.com
TRUEPOSITION	trueposition.com
TRUESAMPLE	truesample.com
TRUESCAPE	truescape.com
TRUESCRIBE	truescribe.net
TRUESENSE	truesense.com
TRUESHIP	trueship.com
TRUETANDEM	truetandem.com
TRUEU	trueu.com
TRUEWATER	truewater.com
TRUEXCULLINS	truexcullins.com
TRUEXTEND	truextend.com
TRUFAST	trufast.com
TRUFFLESOFT	trufflesoft.com
TRUFIG	trufig.com
TRUFRESH	trufresh.net
TRUGLOBAL	truglobal.com
TRUGOLF	trugolf.com
TRUHEARING	truhearing.com
TRUITION	truition.com
TRUKMANNS	trukmanns.com
TRULIA	trulia.com
TRUMEDIA	trumedia.com
TRUMOBI	trumobi.com
TRUMPOWER	trumpower.com
TRUNEL	trunel.com
TRUNORTH	trunorth.biz
TRUORDER	truorder.com
TRUPANION	trupanion.com
TRUPHONE	truphone.com
TRUPRO	trupro.com
TRUQUILL	truquill.com
TRURIM	trurim.com
TRUROCK	trurock.com
TRUSEARCH	trusearch.com
TRUSM	trusm.com
TRUSPER	trusper.com
TRUSSWAY	trussway.com
TRUSTAFF	trustaff.com
TRUSTBANK	trustbank.net
TRUSTCC	trustcc.com
TRUSTCENTRAL	trustcentral.com
TRUSTCLOUD	trustcloud.com
TRUSTCOMMERCE	trustcommerce.com
TRUSTEDADVISORY	trustedadvisory.com
TRUSTEDFAMILY	trustedfamily.net
TRUSTEDFORCE	trustedforce.com
TRUSTEDPEER	trustedpeer.com
TRUSTEDQA	trustedqa.com
TRUSTEGG	trustegg.com
TRUSTIENT	trustient.com
TRUSTIFI	trustifi.com
TRUSTIFS	trustifs.com
TRUSTINTERNATIONAL	trustinternational.com
TRUSTIVO	trustivo.com
TRUSTLR	trustlr.com
TRUSTMARK	trustmark.com
TRUSTMEPC	trustmepc.com
TRUSTPILOT	trustpilot.com
TRUSTSPHERE	trustsphere.com
TRUSTWATER	trustwater.com
TRUSTWAVE	trustwave.com
TRUTANKLESS	trutankless.com
TRUTEGRA	trutegra.com
NETSOLUS	netsolus.com
NETSONIC	netsonic.net
NETSPEND	netspend.com
NETSPI	netspi.com
NETSPINNERS	netspinners.com
NETSPOTS	netspots.com
NETSTEADY	netsteady.com
NETSTEPS	netsteps.com
NETSTRATEGIES	netstrategies.com
NETSTREAMS	netstreams.com
NETSTRIDE	netstride.com
NETSTRUCTURES	netstructures.com
NETSUITE	netsuite.com
NETSUTRA	netsutra.com
NETTINGSOLUTIONS	nettingsolutions.com
NETTRAV	nettrav.com
NETTREKKER	nettrekker.com
NETTRONICS	nettronics.net
NETUITIVE	netuitive.com
NETURALLYSPEAKING	neturallyspeaking.com
NETVAD	netvad.com
NETVEANO	netveano.com
NETVENDOR	netvendor.net
NETVERSANT	netversant.com
NETVERSED	netversed.com
NETVERSITY	netversity.com
NETVESTA	netvesta.com
NETVILLAGE	netvillage.com
NETVISIBILITIES	netvisibilities.com
NETVU	netvu.org
NETWAITER	netwaiter.com
NETWIRKS	netwirks.com
NETWITNESS	netwitness.com
NETWOLVES	netwolves.com
NETWORK180	network180.org
NETWORK1SPORTS	network1sports.com
NETWORK211	network211.com
NETWORK9	network9.biz
NETWORKCSI	networkcsi.com
NETWORKDEPOT	networkdepot.com
NETWORKIP	networkip.net
NETWORKLIFT	networklift.com
NETWORKPENINSULA	networkpeninsula.org
NETWORKTECHS	networktechs.biz
NETWORKTHERMOSTAT	networkthermostat.com
NETWOVEN	netwoven.com
NETWURX	netwurx.net
NETXOTIC	netxotic.com
NETXUSA	netxusa.com
NEUBLOC	neubloc.com
NEUBRAIN	neubrain.com
NEUCOMPANIES	neucompanies.com
NEUDESIC	neudesic.com
NEUEON	neueon.com
NEUGAMUT	neugamut.com
NEUKIN	neukin.com
NEULOGICS	neulogics.com
NEUNERPATE	neunerpate.com
NEUNOIA	neunoia.com
NEURACOMM	neuracomm.com
NEURALA	neurala.com
NEURALOG	neuralog.com
NEURALPOP	neuralpop.com
NEURALYNX	neuralynx.com
NEURILINK	neurilink.com
NEUROEDGETRADER	neuroedgetrader.com
NEUROFOCUS	neurofocus.com
NEUROGENIX	neurogenix.net
NEUROGIC	neurogic.com
NEUROINTERNATIONAL	neurointernational.com
NEUROLOGICA	neurologica.com
NEUROMETRIX	neurometrix.com
NEUROMORPHOMETRICS	neuromorphometrics.com
NEURONES	neurones.net
NEURONETICS	neuronetics.com
NEUROPACE	neuropace.com
NEUROSEARCH	neurosearch.com
NEUROSIGMA	neurosigma.com
NEUROSPIRE	neurospire.com
NEUROTARGETING	neurotargeting.com
NEUROTEXAS	neurotexas.net
NEUROTRACK	neurotrack.com
NEUROVIRTUAL	neurovirtual.com
NEUROVISIONS	neurovisions.com
NEUROVISTA	neurovista.com
NEUROVIZION	neurovizion.com
NEUROZON	neurozon.com
NEUSTAR	neustar.biz
NEUSTAR	neustar.com
NEUSTEP	neustep.com
NEUSTUDIOS	neustudios.com
NEUTRADERM	neutraderm.com
NEUTRIK	neutrik.com
NEUVEST	neuvest.com
NEVADAWORKS	nevadaworks.com
NEVARA	nevara.org
NEVATECH	nevatech.com
NEVCOENERGY	nevcoenergy.com
NEVERSTOP	neverstop.com
NEVERWARE	neverware.com
NEVHC	nevhc.org
NEVOLUTION	nevolution.com
NEVOTEK	nevotek.com
NEVTEC	nevtec.com
NEW-A	new-a.com
NEWAIR	newair.com
NEWAPERIO	newaperio.com
NEWARK	newark.com
NEWATLANTICWEB	newatlanticweb.com
NEWBBLE	newbble.com
NEWBREATH	newbreath.net
NEWBREED	newbreed.com
NEWBURGER-ANDES	newburger-andes.com
NEWCARDIO	newcardio.com
NEWCAREERS	newcareers.com
NEWCLIENTS	newclients.com
NEWCOIT	newcoit.com
NEWCOMLINK	newcomlink.com
NEWCOURTLAND	newcourtland.org
NEWCRESTIMAGE	newcrestimage.com
NEWDEA	newdea.com
NEWDEALDESIGN	newdealdesign.com
NEWDIGS	newdigs.com
NEWDIRT	newdirt.com
NEWDUST	newdust.com
NEWEDGE	newedge.com
NEWEDI	newedi.com
NEWELLTHINKING	newellthinking.com
NEWENCY	newency.com
NEWESTRA	newestra.com
NEWFIELDS	newfields.com
NEWFORMA	newforma.com
NEWGENAEROSPACE	newgenaerospace.com
NEWGISTICS	newgistics.com
NEWGLYPHICS	newglyphics.com
NEWGROUND	newground.com
NEWH	newh.org
NEWHIRE	newhire.com
NEWHOMETRENDS	newhometrends.com
NEWKIRK	newkirk.com
NEWLANS	newlans.com
NEWLEADS	newleads.com
NEWLINEINFO	newlineinfo.com
NEWLYWISH	newlywish.com
NEWMANPR	newmanpr.com
NEWMARKETBUILDERS	newmarketbuilders.com
NEWMARKETINC	newmarketinc.com
NEWMEDIAGRAPHFX	newmediagraphfx.com
NEWMEDIAPLUS	newmediaplus.com
NEWMEDIAROCKSTARS	newmediarockstars.com
NEWMEDICAL	newmedical.com
NEWMENTOR	newmentor.com
NEWMGROUP	newmgroup.com
NEWMOA	newmoa.org
NEWMONT	newmont.com
NEWNETSOLUTIONS	newnetsolutions.net
NEWONICS	newonics.com
WICR	wicr.net
WICRESOFT	wicresoft.com
WIDEORBIT	wideorbit.com
WIDEPOINT	widepoint.com
WIDESTREETS	widestreets.com
WIDIA	widia.com
WIECK	wieck.com
WIEGO	wiego.org
WIESEUSA	wieseusa.com
WIFAST	wifast.com
WIFH	wifh.com
WIFIGATOR	wifigator.com
WIGGIO	wiggio.com
WIGSALON	wigsalon.com
WIGWAG	wigwag.com
WIHIGH	wihigh.com
WIHRI	wihri.org
WIKETS	wikets.com
WIKIBON	wikibon.org
WIKICOLLECTABLES	wikicollectables.com
WIKIHOW	wikihow.com
WIKILIGHTENMENT	wikilightenment.com
WIKIMOTIVE	wikimotive.com
WIKIORGCHARTS	wikiorgcharts.com
WIKIPACKS	wikipacks.com
WIKIPAD	wikipad.com
WIKIPAY	wikipay.com
WIKIREALTY	wikirealty.com
WIKISPEED	wikispeed.com
WIKISTRAT	wikistrat.com
WIKREATE	wikreate.com
WIL-SPEC	wil-spec.com
WILBANKSELAM	wilbankselam.com
WILCON	wilcon.com
WILDBIT	wildbit.com
WILDCHINA	wildchina.com
WILDCOAST	wildcoast.net
WILDCOG	wildcog.com
WILDCOMM	wildcomm.com
WILDECK	wildeck.com
WILDERNESSWISE	wildernesswise.com
WILDFOX	wildfox.com
TRUTEK	trutek.com
TRUTHDIG	truthdig.com
TRUTHOUT	truthout.org
TRUVANTIS	truvantis.com
TRUVEON	truveon.com
TRUVERIS	truveris.com
TRUVISTA	truvista.net
TRW	trw.com
TRX	trx.com
TRYGS	trygs.com
TRYGTECH	trygtech.com
TRYLON	trylon.com
TRYMPH	trymph.com
TRYPILLIAN	trypillian.com
TRYSTAR	trystar.com
TSAADVET	tsaadvet.com
TSACHOICE	tsachoice.com
TSANET	tsanet.org
TSC	tsc.com
TSCNBEYOND	tscnbeyond.org
TSCPA	tscpa.net
TSHEETS	tsheets.com
TSI	tsi.com
TSIA	tsia.com
TSIMED	tsimed.com
TSM	tsm.com
TSMC	tsmc.com
TSMGI	tsmgi.com
TSMWORKS	tsmworks.com
TSO3	tso3.com
TSPEC	tspec.com
TSS	tss.com
TSSAA	tssaa.org
TSSLINK	tsslink.com
TSTC	tstc.edu
TSUNELA	tsunela.com
TSYS	tsys.com
TTCG	ttcg.com
TTCINNOVATIONS	ttcinnovations.com
TTCNASHVILLE	ttcnashville.edu
TTGLOBAL	ttglobal.biz
TTL-ARCHITECTS	ttl-architects.com
TTOPCO	ttopco.com
TTPCOM	ttpcom.com
TTU	ttu.edu
TTUHSC	ttuhsc.edu
TTWEAK	ttweak.com
TUAW	tuaw.com
TUBEART	tubeart.com
TUBEFILTER	tubefilter.com
TUBELITE	tubelite.com
TUBIFI	tubifi.com
TUBMAN	tubman.org
TUBOCRETO	tubocreto.com
TUCANOS	tucanos.com
TUCKNOLOGIES	tucknologies.com
TUDLA	tudla.com
TUFFWERX	tuffwerx.com
TUFIN	tufin.com
TUFTS	tufts.edu
TUFTSMEDICALCENTER	tuftsmedicalcenter.org
TUKAIZ	tukaiz.com
TUKIOS	tukios.com
TUKUTE	tukute.net
TULANE	tulane.edu
TULLY	tully.org
TULSACONNECT	tulsaconnect.com
TULSAT	tulsat.com
TUMBALINA	tumbalina.com
TUMBLEROOT	tumbleroot.com
TUMERICALIVE	tumericalive.com
TUMI	tumi.com
TUMIS	tumis.com
TUMMYTOYS	tummytoys.com
TUMOKI	tumoki.com
TUMULT	tumult.com
TUNARISOFT	tunarisoft.com
TUNDALAYA	tundalaya.com
TUNE	tune.com
TUNECORE	tunecore.com
TUNESAT	tunesat.com
TUNESPEAK	tunespeak.com
TUNETAP	tunetap.com
TUNEWOLF	tunewolf.com
TUNEX	tunex.com
TUNHEIM	tunheim.com
TUNISAIR	tunisair.com
TUNNELBRAVO	tunnelbravo.com
TUPPERWARE	tupperware.com
TURANT	turant.org
TURBINE	turbine.com
TURBINEPROS	turbinepros.com
TURBO-WASH	turbo-wash.com
TURBOCAM	turbocam.com
TURBOCARE	turbocare.com
TURBOCHEF	turbochef.com
TURBOHAUL	turbohaul.com
TURBOKRAFT	turbokraft.com
TURBOLOGISTICS	turbologistics.com
TURBOMACH	turbomach.com
TURBOMECA	turbomeca.com
TURBOSQUID	turbosquid.com
TURELK	turelk.com
TURFCO	turfco.com
TURFDIRECT	turfdirect.com
TURFHOUND	turfhound.com
TURING	turing.com
TURINGSMI	turingsmi.com
TURKEYVISION	turkeyvision.com
TURLYBIRD	turlybird.com
TURN	turn.com
TURNCLICK	turnclick.com
TURNER	turner.com
TURNHERE	turnhere.com
TURNINGWEST	turningwest.com
TURNMVP	turnmvp.com
TURNONDYNAMICS	turnondynamics.com
TURNOUTNOW	turnoutnow.com
TURNPOST	turnpost.com
TURNSWING	turnswing.com
TURTLESON	turtleson.com
TURTLETIQUE	turtletique.com
TUSCABLUE	tuscablue.com
TUSCANO	tuscano.com
TUSCLICKS	tusclicks.com
TUSKEGEE	tuskegee.edu
TUSSLE	tussle.com
TUTCO	tutco.com
TUTOR4GREATNESS	tutor4greatness.com
TUTORABC	tutorabc.com
TUTORBRIGHT	tutorbright.com
TUTORINGONE	tutoringone.com
TUTORJOHN	tutorjohn.com
TUTORMASTERPRO	tutormasterpro.com
TUTORMEASAP	tutormeasap.com
TUTORMELA	tutormela.com
TUTORPEDIA	tutorpedia.com
TUTORSPREE	tutorspree.com
TUTORTUTOR	tutortutor.org
TUTTNAUER	tuttnauer.com
TUUCI	tuuci.com
TUVALABS	tuvalabs.com
TUVIDERM	tuviderm.com
TUXEGO	tuxego.com
TV5MONDE	tv5monde.com
TV9	tv9.net
TVA	tva.gov
TVB	tvb.org
TVECA	tveca.com
TVEYES	tveyes.com
TVGA	tvga.com
TVGLA	tvgla.com
TVLIZE	tvlize.com
TVMCGILL	tvmcgill.com
TVOVERMIND	tvovermind.com
TVSCO	tvsco.com
TVT	tvt.biz
TVTOMORROW	tvtomorrow.com
TWAINSTEIN	twainstein.com
TWANG	twang.com
VIACUBE	viacube.com
VIADESIGN	viadesign.com
VIADOR	viador.com
VIAFIELD	viafield.com
VIAFORENSICS	viaforensics.com
VIAGEN	viagen.com
VIAHEALTH	viahealth.org
VIAKAY	viakay.com
VIALLO	viallo.com
VIALOGY	vialogy.com
VIAMERICAS	viamericas.com
VIAMETRIC	viametric.com
VIAMICHELIN	viamichelin.com
VIANT	viant.com
VIASANT	viasant.com
VIASAT	viasat.com
VIASENSOR	viasensor.com
VIASINC	viasinc.com
VIASPIRE	viaspire.com
VIASTARA	viastara.com
VIASTO	viasto.com
VIASYSTEMS	viasystems.com
VIATASK	viatask.com
VIATION	viation.com
VIATRAN	viatran.com
VIAVERO	viavero.com
VIAWEST	viawest.com
VIAWEST	viawest.net
VIBEMOVE	vibemove.com
VIBERAGENCY	viberagency.com
VIBES	vibes.com
VIBESBASE	vibesbase.com
VIBETHINK	vibethink.com
VIBEVOIP	vibevoip.com
VIBHA	vibha.org
VIBIO	vibio.com
VIBRANTCY	vibrantcy.org
VIBS	vibs.org
VICA	vica.com
VICAL	vical.com
VICAM	vicam.com
VICIDIEM	vicidiem.com
VICINETY	vicinety.com
VICKEREY	vickerey.com
VICKIVIRTUALOFFICE	vickivirtualoffice.com
VICMEDIA	vicmedia.net
VICON	vicon.com
VICOSTONE	vicostone.com
VICSD	vicsd.com
VICTAULIC	victaulic.com
VICTIG	victig.com
VICTOR	victor.org
VICTORIOUS	victorious.com
VICTRIO	victrio.com
VICTRON	victron.com
VIDACARE	vidacare.com
VIDADBOX	vidadbox.com
VIDALTEK	vidaltek.com
VIDARGO	vidargo.com
VIDAROO	vidaroo.com
VIDBOLT	vidbolt.com
VIDCLX	vidclx.com
VIDCRUITER	vidcruiter.com
VIDDER	vidder.com
VIDDYAD	viddyad.com
VIDEK	videk.com
VIDENT	vident.com
VIDEOACTIVE	videoactive.com
VIDEOFASHION	videofashion.com
VIDEOFIED	videofied.com
VIDEOFORT	videofort.com
VIDEOFP	videofp.com
VIDEOGENIE	videogenie.com
VIDEOGENIX	videogenix.com
VIDEOGRAPHICA	videographica.com
VIDEOHUB	videohub.com
VIDEOIQ	videoiq.com
VIDEOIR	videoir.com
VIDEOJET	videojet.com
VIDEOJUICER	videojuicer.com
VIDEOLARM	videolarm.com
VIDEOLICIOUS	videolicious.com
VIDEONEXT	videonext.com
VIDEONITCH	videonitch.com
VIDEOPHOTOSHOW	videophotoshow.com
VIDEOPLUS	videoplus.com
VIDEOPROPULSION	videopropulsion.com
VIDEORX	videorx.com
VIDEOSCOPE	videoscope.com
VIDEOSONIC	videosonic.com
VIDEOTOV	videotov.com
VIDESKTOP	videsktop.com
VIDEX	videx.com
VIDEXIO	videxio.com
VIDFILMS	vidfilms.com
VIDGAGE	vidgage.com
VIDGITS	vidgits.com
VIDIPLANET	vidiplanet.com
VIDISTAR	vidistar.com
VIDIZMO	vidizmo.com
VIDKEY	vidkey.com
VIDMAGAZINE	vidmagazine.com
VIDMUZE	vidmuze.com
VIDOX	vidox.com
VIDP	vidp.net
VIDROMEDIA	vidromedia.com
VIDSCALE	vidscale.com
VIDSOCIALLY	vidsocially.com
VIDSPORTTV	vidsporttv.com
VIDSYS	vidsys.com
VIDTIGER	vidtiger.com
VIDTOK	vidtok.com
VIDWAL	vidwal.com
VIDYO	vidyo.com
VIDZEY	vidzey.com
VIEGA	viega.com
VIEJAS	viejas.com
VIELIFE	vielife.com
VIENNEMILANO	viennemilano.com
VIEON	vieon.net
VIERBICHER	vierbicher.com
VIETHOPE	viethope.org
VIETJETAIR	vietjetair.com
VIEWBOOST	viewboost.com
VIEWDLE	viewdle.com
VIEWFINDERPRO	viewfinderpro.com
VIEWFINITY	viewfinity.com
VIEWGOO	viewgoo.com
VIEWISTA	viewista.com
VIEWMARK	viewmark.com
VIEWMARKET	viewmarket.com
VIEWMONITOR	viewmonitor.com
VIEWPATH	viewpath.com
VIEWPOINTE	viewpointe.com
VIEWPOST	viewpost.com
VIEWSONIC	viewsonic.com
VIEWSTREAM	viewstream.com
VIGEL	vigel.com
VIGET	viget.com
VIGILAR	vigilar.com
VIGILENT	vigilent.com
VIGILISTICS	vigilistics.com
VIGITRUST	vigitrust.com
VIGLINK	viglink.com
VIGNETTE	vignette.com
VIGNON	vignon.com
VIIAD	viiad.com
VIIMED	viimed.com
VIIXII	viixii.com
VIKI	viki.com
VIKIMATIC	vikimatic.com
VIKWOOD	vikwood.com
VILA	vila.com
VILEBREQUIN	vilebrequin.com
VILEX	vilex.com
VILLADIRECT	villadirect.com
VILLAGEEDOCS	villageedocs.com
VILLAGEMD	villagemd.com
VILLAGEREACH	villagereach.org
VILLAGESOUP	villagesoup.com
VILLAGIS	villagis.com
VILLAINS	villains.com
VILLANOVA	villanova.edu
VILLAS2000	villas2000.com
VILLAZZO	villazzo.com
VILOX	vilox.com
VILYNX	vilynx.com
VIMARC	vimarc.com
VIMBLY	vimbly.com
VIMBRIO	vimbrio.com
VIMCORE	vimcore.com
VIMEDICUS	vimedicus.com
VIMENTURE	vimenture.com
VIMEO	vimeo.com
VIMICRO	vimicro.com
VIMIFY	vimify.com
VIMO	vimo.com
VIMODI	vimodi.com
VIMPELCOM	vimpelcom.com
VIMS	vims.edu
VIMTRIM	vimtrim.com
VIMTY	vimty.com
VIMULTI	vimulti.com
VIN	vin.com
VIN65	vin65.com
VINACAPITAL	vinacapital.com
VINAKOM	vinakom.com
VINASOURCE	vinasource.com
VINASSET	vinasset.com
VINCENTBENJAMIN	vincentbenjamin.com
VINCENTCURTIS	vincentcurtis.com
VINCHIP	vinchip.com
VINCODO	vincodo.com
VINCOTECH	vincotech.com
VINCULUMS	vinculums.com
VINDICIA	vindicia.com
VINDICOR	vindicor.com
VINDUVIN	vinduvin.com
VINEARTS	vinearts.net
VINECRAFT	vinecraft.com
VINEPAIR	vinepair.com
VINESEED	vineseed.com
VINEUP	vineup.com
VINEYARD2DOOR	vineyard2door.com
VINFEN	vinfen.org
VINFOLIO	vinfolio.com
VINFORMATIVE	vinformative.com
VINFOTECH	vinfotech.com
VINGD	vingd.com
VINGDIRECT	vingdirect.com
VINGLE	vingle.net
VINIMAYA	vinimaya.com
VINMAPS	vinmaps.com
VINOCOPIA	vinocopia.com
VINODIVINO	vinodivino.com
VINOLOVERS	vinolovers.com
VINOPRO	vinopro.com
VINOSHIPPER	vinoshipper.com
VINOSMITH	vinosmith.com
VINOTEMP	vinotemp.com
VINPAK	vinpak.com
VINSOL	vinsol.com
VINSOLUTIONS	vinsolutions.com
VINTAE	vintae.com
VINTAGE415	vintage415.com
VINTAGEBLESSINGS	vintageblessings.com
VINTAGEDANCER	vintagedancer.com
VINTAGEFACTOR	vintagefactor.com
VINTAGEREMADE	vintageremade.com
VINTANK	vintank.com
VINTCHIP	vintchip.com
VINTED	vinted.com
VINTEK	vintek.com
VINTIMAR	vintimar.com
VINTOVINO	vintovino.com
VINVELI	vinveli.org
VINYLMINT	vinylmint.com
VINYLUX	vinylux.net
VINYLVISIONS	vinylvisions.net
VIOCARE	viocare.com
VIOLET3D	violet3d.com
VIOLETMOUSE	violetmouse.com
VIOLIFE	violife.com
VIOLINIST	violinist.com
VIOLINISTO	violinisto.com
VION	vion.com
VIONIC	vionic.com
VIONIQ	vioniq.com
VIOSKI	vioski.com
VIPAAR	vipaar.com
VIPAC	vipac.com
VIPBARTENDERS	vipbartenders.com
VIPBOOKER	vipbooker.com
VIPDESK	vipdesk.com
VIPDESTINY	vipdestiny.com
VIPOASIA	vipoasia.com
VIPORBIT	viporbit.com
VIPRAINFOSYSTEMS	viprainfosystems.com
VIPRIDE	vipride.com
VIPROFIX	viprofix.com
VIPS	vips.com
VIPTEXTDEALS	viptextdeals.com
VIPTEXTDEALS	viptextdeals.net
VIPZE	vipze.com
VIQUA	viqua.com
VIRACON	viracon.com
VIRALMESH	viralmesh.com
VIRALSWEEP	viralsweep.com
VIRALTRADE	viraltrade.com
VIRASOURCE	virasource.com
VIRCO	virco.com
VIRDATUM	virdatum.com
VIRGINIA21	virginia21.org
VIRID	virid.com
VIRIDIAN	viridian.com
VIRIDIS3D	viridis3d.com
VIRIDIUN	viridiun.com
VIRIDO	virido.com
VIRINCHI	virinchi.com
VIRONEX	vironex.com
VIROOL	virool.com
VIRPACK	virpack.com
VIRSO	virso.com
VIRSOCOM	virsocom.com
VIRSYS12	virsys12.com
VIRTELLIGENCE	virtelligence.com
VIRTEVA	virteva.com
VIRTICUS	virticus.com
VIRTISM	virtism.com
VIRTIUM	virtium.com
VIRTJOULE	virtjoule.com
VIRTOSOFTWARE	virtosoftware.com
VIRTRU	virtru.com
VIRTUA	virtua.org
VIRTUALBEAM	virtualbeam.com
VIRTUALDOORWAY	virtualdoorway.com
VIRTUALHEALTHSYSTEMS	virtualhealthsystems.net
VIRTUALISM	virtualism.net
VIRTUALLIN	virtuallin.com
VIRTUALLOGIX	virtuallogix.com
VIRTUALLYINSYNC	virtuallyinsync.com
VIRTUALOFFICE2U	virtualoffice2u.com
VIRTUALSCOPICS	virtualscopics.com
VIRTUALTECH	virtualtech.com
VIRTUALTONE	virtualtone.net
VIRTUALWIRKS	virtualwirks.com
VIRTUALWORKS	virtualworks.com
VIRTUANCE	virtuance.com
VIRTUASSIST	virtuassist.biz
VIRTUEINFO	virtueinfo.com
VIRTUEMART	virtuemart.net
VIRTUEONLINE	virtueonline.org
VIRTUOSITY	virtuosity.com
VIRTUOSO	virtuoso.com
VIRTUOSONLINE	virtuosonline.com
VIRTUOX	virtuox.net
VIRTUSA	virtusa.com
VIRTUTEM	virtutem.com
VIRUN	virun.com
VIRYANET	viryanet.com
VIS-HOME	vis-home.com
VISA	visa.com
VISABILITY	visability.com
VISABLY	visably.com
VISALIA	visalia.com
VISALUS	visalus.com
VISAOMD	visaomd.com
VISAVISCOSMETICS	visaviscosmetics.com
VISCIRA	viscira.com
VISDE	visde.com
VISDECOL	visdecol.com
VISEAN	visean.com
VISFIRE	visfire.com
VISHAY	vishay.com
VISIBIUM	visibium.com
VISIBLETHREAD	visiblethread.com
VISICOR	visicor.net
VISIGENIX	visigenix.com
VISIGRAL	visigral.com
VISILIO	visilio.com
VISILUNA	visiluna.com
VISINOW	visinow.net
VISIO	visio.org
VISION-VEST	vision-vest.com
VISION	vision.com
VISION2VOICE	vision2voice.com
VISION360	vision360.org
VISIONAGE	visionage.net
VISIONAIRLLC	visionairllc.com
VISIONALITY	visionality.com
VISIONARIA	visionaria.com
VISIONATIONS	visionations.com
VISIONCOR	visioncor.com
VISIONCOURSEMEDIA	visioncoursemedia.com
VISIONEER	visioneer.com
VISIONFIRST	visionfirst.com
VISIONGUILD	visionguild.com
VISIONIT	visionit.com
VISIONIX	visionix.com
VISIONIZ	visioniz.com
VISIONLINK	visionlink.org
VISIONMARK	visionmark.com
VISIONMAX	visionmax.com
VISIONPERRY	visionperry.com
VISIONPILOTS	visionpilots.com
VISIONSMITH	visionsmith.com
VISIONSOLUTIONS	visionsolutions.com
VISIONSPRING	visionspring.org
VISIONSPRR	visionsprr.com
VISIONSTAR	visionstar.com
VISIONSTREAM	visionstream.com
VISIONTECH360	visiontech360.com
VISIONTECHSYSTEMS	visiontechsystems.net
VISIONTREE	visiontree.com
VISIONWARE	visionware.com
VISIONWEB	visionweb.com
VISIONWORKS	visionworks.net
VISIOUS	visious.com
VISIPAK	visipak.com
VISIPRISE	visiprise.com
VISISOFT	visisoft.com
VISISTAT	visistat.com
VISITBRITAIN	visitbritain.org
VISITDAYS	visitdays.com
VISITEC	visitec.com
VISITENGLAND	visitengland.org
VISITERIE	visiterie.com
VISITIRELAND	visitireland.com
VISITLEX	visitlex.com
VISITORSCOVERAGE	visitorscoverage.com
VISITPITTSBURGH	visitpittsburgh.com
VISITREND	visitrend.com
VISITROCHESTER	visitrochester.com
VISITRUSSIA	visitrussia.com
VISITSWEDEN	visitsweden.com
VISITTULSA	visittulsa.com
VISIUM	visium.com
VISIWARE	visiware.com
VISJOU	visjou.com
VISOLVE	visolve.com
VISONEX	visonex.com
VISONUS	visonus.com
VISPRONET	vispronet.com
VISSENY	visseny.com
VISSLA	vissla.com
VISSUMO	vissumo.com
VISTABRAND	vistabrand.com
VISTACARE	vistacare.com
VISTACOLOR	vistacolor.com
VISTACOMM	vistacomm.com
VISTACONNECTIONS	vistaconnections.com
VISTAGE	vistage.com
VISTAGRANDE	vistagrande.com
VISTAGY	vistagy.com
VISTAIMS	vistaims.com
VISTAMATIC	vistamatic.com
VISTAONE	vistaone.com
VISTAPRINT	vistaprint.com
VISTARUS	vistarus.com
VISTATEC	vistatec.com
VISTAWALL	vistawall.com
VISTELAR	vistelar.com
VISTEON	visteon.com
VISTEX	vistex.com
VISTRACKS	vistracks.com
VISTRADA	vistrada.com
VISTRONIX	vistronix.com
VISUAL28	visual28.com
VISUALANT	visualant.net
VISUALCV	visualcv.com
VISUALETIQUETTE	visualetiquette.com
VISUALITY	visuality.com
VISUALMANIAC	visualmaniac.com
VISUALNET	visualnet.com
VISUALSCOPE	visualscope.com
VISUALSHARE	visualshare.com
VISUALSONICS	visualsonics.com
VISUALSSPEAK	visualsspeak.com
VISUALTOUR	visualtour.com
VISUALTUBE	visualtube.com
VISUALUTIONS	visualutions.com
VISUALVAULT	visualvault.com
VISULAR	visular.com
VISULON	visulon.com
VISURAY	visuray.com
VITA	vita.com
VITABENS	vitabens.com
VITABOT	vitabot.com
VITAC	vitac.com
VITACO	vitaco.org
VITACYTE	vitacyte.com
VITAHOUND	vitahound.com
VITAID	vitaid.com
VITALAXIS	vitalaxis.com
VITALEDI	vitaledi.com
VITALEMILLERCPA	vitalemillercpa.com
VITALEQUITY	vitalequity.com
VITALOGICS	vitalogics.net
VITALPUNCTURE	vitalpuncture.com
VITALS	vitals.com
VITALSMARTS	vitalsmarts.com
VITALSOFTTECH	vitalsofttech.com
VITALSPRING	vitalspring.com
VITALTHOUGHT	vitalthought.com
VITALVERB	vitalverb.com
VITALVU	vitalvu.com
VITALWARE	vitalware.com
VITALZ	vitalz.com
VITAMEDICA	vitamedica.com
VITAMIX	vitamix.com
VITAQUEST	vitaquest.com
VITAS	vitas.com
VITBERGLLC	vitbergllc.com
VITEBMOBILEAPPS	vitebmobileapps.com
VITECHNOLOGY	vitechnology.com
VITECONLINE	viteconline.com
VITEOS	viteos.com
VITETTA	vitetta.com
VITEX	vitex.com
VITL	vitl.net
VITMARK	vitmark.com
VITOGO	vitogo.com
VITOPIAN	vitopian.com
VITRA	vitra.com
VITRAZZA	vitrazza.com
VITRIA	vitria.com
VITRO	vitro.com
VITROLIFE	vitrolife.com
VITRUE	vitrue.com
VITSOE	vitsoe.com
VITSOFT	vitsoft.com
VITUSVET	vitusvet.com
VIUMBE	viumbe.com
VIVAAEROBUS	vivaaerobus.com
VIVACARE	vivacare.com
VIVACHE	vivache.com
VIVACITY	vivacity.net
VIVAKI	vivaki.com
VIVANTECH	vivantech.com
VIVARE	vivare.net
VIVARTE	vivarte.com
VIVARTIA	vivartia.com
VIVASTREAM	vivastream.com
VIVAYIC	vivayic.com
VIVEBIO	vivebio.com
VIVENDI	vivendi.com
VIVENET	vivenet.com
VIVENTURA	viventura.com
VIVERANT	viverant.com
VIVID-HOSTING	vivid-hosting.net
VIVIDIANSOFT	vividiansoft.com
VIVIDMIX	vividmix.com
VIVIDNET	vividnet.com
VIVIDSITES	vividsites.com
VIVIENDASLEON	viviendasleon.org
VIVINO	vivino.com
VIVIOSITES	viviosites.com
VIVIOSOFT	viviosoft.com
VIVISCAPE	viviscape.com
VIVITIV	vivitiv.com
VIVNIUM	vivnium.com
VIVOBAREFOOT	vivobarefoot.com
VIVOMIND	vivomind.com
VIVONOETICS	vivonoetics.com
VIVOPOOLS	vivopools.com
VIVOX	vivox.com
VIVTEK	vivtek.com
VIVUS	vivus.com
VIWINTECH	viwintech.com
VIXELY	vixely.com
VIXICOM	vixicom.com
VIXLET	vixlet.com
VIYET	viyet.com
VIYOLO	viyolo.com
VIZADA	vizada.com
VIZAEON	vizaeon.com
VIZANTIA	vizantia.com
VIZARDZ	vizardz.com
VIZBUILT	vizbuilt.com
VIZERGY	vizergy.com
VIZERY	vizery.com
VIZEUM	vizeum.com
VIZIFY	vizify.com
VIZIO	vizio.com
VIZIONCORE	vizioncore.com
VIZKICK	vizkick.com
VIZLINGO	vizlingo.com
VIZOCOM	vizocom.com
VIZSY	vizsy.com
VIZTEK	viztek.net
VIZUALIIZ	vizualiiz.com
VIZUP	vizup.com
VIZURI	vizuri.com
VIZWERKS	vizwerks.com
VIZZDA	vizzda.com
VIZZUALITY	vizzuality.com
VJNETWORKS	vjnetworks.com
VKERNEL	vkernel.com
VKMI	vkmi.org
VKPICTURES	vkpictures.com
VLAMP	vlamp.com
VLEA	vlea.org
VLEXINC	vlexinc.com
VLF7	vlf7.com
VLINGO	vlingo.com
VLSYSTEMS	vlsystems.com
VMAC	vmac.com
VMATRIX	vmatrix.com
VMC	vmc.com
VMDIRECT	vmdirect.com
VMDNET	vmdnet.com
VMENGINEERING	vmengineering.com
VMGROUPE	vmgroupe.com
VMICA	vmica.com
VMIX	vmix.com
VML	vml.com
VMMC	vmmc.org
VMPOOL	vmpool.com
VMRC	vmrc.org
VMSOURCES	vmsources.com
VMTURBO	vmturbo.com
VMWARE	vmware.com
VNACELLE	vnacelle.com
VNACOLORS	vnacolors.com
VNASCC	vnascc.org
VNETSOFTWARE	vnetsoftware.com
VNRC	vnrc.org
VNSM	vnsm.net
VNSNY	vnsny.org
VNTANA	vntana.com
VOABA	voaba.org
VOALTE	voalte.com
VOBI	vobi.com
VOBOK	vobok.com
VOCADO	vocado.com
VOCALABS	vocalabs.com
VOCALCLOUD	vocalcloud.com
VOCALESSENCE	vocalessence.org
VOCALINK	vocalink.com
VOCALITY	vocality.com
VOCALOCITY	vocalocity.com
VOCALOIDISM	vocaloidism.com
VOCAREUM	vocareum.com
VOCATECH	vocatech.com
VOCATIV	vocativ.com
VOCCII	voccii.com
VOCERA	vocera.com
VOCIO	vocio.com
VOCISPA	vocispa.com
VOCLARION	voclarion.com
VOCOLLECT	vocollect.com
VOCOMOTION	vocomotion.com
VOCON	vocon.com
VOCUS	vocus.com
VOCWORKS	vocworks.com
VODAFONE	vodafone.com
VODALITY	vodality.com
VODAPLEX	vodaplex.com
VODBRO	vodbro.com
VODORI	vodori.com
VODPOD	vodpod.com
VOE	voe.org
VOGODESIGNS	vogodesigns.com
VOGUESTRAP	voguestrap.com
VOICE2INSIGHT	voice2insight.com
VOICE4GIRLS	voice4girls.org
VOICE4NET	voice4net.com
VOICEABLY	voiceably.com
VOICEBROOK	voicebrook.com
VOICEFLIX	voiceflix.com
VOICEFRIEND	voicefriend.net
VOICEGLANCE	voiceglance.com
VOICEHIT	voicehit.com
VOICENATION	voicenation.com
VOICENET	voicenet.com
VOICEONYX	voiceonyx.com
VOICEPAD	voicepad.com
VOICEPLEX	voiceplex.net
VOICEPORT	voiceport.net
VOICEPRO	voicepro.com
VOICERCISE	voicercise.com
VOICESONIC	voicesonic.com
VOICEWALK	voicewalk.net
VOICEXNET	voicexnet.com
VOIGTWORKS	voigtworks.com
VOILART	voilart.net
VOIPHEAD	voiphead.com
VOIPINFOBASE	voipinfobase.com
VOIPO	voipo.com
VOITEQ	voiteq.com
VOITH	voith.com
VOIVODA	voivoda.com
VOKENT	vokent.com
VOLANTIC	volantic.com
VOLANTO	volanto.net
VOLAREWEB	volareweb.com
VOLARIS	volaris.com
VOLATIX	volatix.com
VOLATOUR	volatour.com
VOLAUDITS	volaudits.com
VOLCOM	volcom.com
VOLDEA	voldea.com
VOLENDAY	volenday.com
VOLENTUM	volentum.com
VOLEX	volex.com
VOLI	voli.com
VOLICON	volicon.com
VOLKERT	volkert.com
VOLLEYBALL1ON1	volleyball1on1.com
VOLLEYMETRICS	volleymetrics.com
VOLNADO	volnado.com
VOLOCALL	volocall.com
VOLOGON	vologon.com
VOLOMETRIX	volometrix.com
VOLPATT	volpatt.com
VOLPIT	volpit.com
VOLT	volt.com
VOLTARI	voltari.com
VOLTAS	voltas.com
VOLTDELTA	voltdelta.com
VOLTERNAL	volternal.com
VOLTERRA	volterra.com
VOLTEXX	voltexx.com
VOLTPOTENTIAL	voltpotential.com
VOLTT	voltt.org
VOLUBILL	volubill.com
VOLUMATIC	volumatic.com
VOLUMEONE	volumeone.com
VOLUMESQUARED	volumesquared.com
VOLUNTEERMARK	volunteermark.com
VOLUNTIS	voluntis.com
VOLUSION	volusion.com
VOLUTONE	volutone.com
VOMAX	vomax.com
VOMELA	vomela.com
VONAGE	vonage.com
VONAZON	vonazon.com
VONCHURCH	vonchurch.com
VONCIERGE	voncierge.com
VONCOM	voncom.com
VONETIZE	vonetize.com
VONETO	voneto.com
VONIGO	vonigo.com
VONLAY	vonlay.com
VONSUNG	vonsung.com
VONTOO	vontoo.com
VONTU	vontu.com
VONZIPPER	vonzipper.com
VOODOOSHIELD	voodooshield.com
VOOLII	voolii.com
VOOLLA	voolla.org
VOONAMI	voonami.com
VOONDER	voonder.com
VOORMI	voormi.com
VOPAK	vopak.com
VOPORTA	voporta.com
VOR	vor.net
VORELART	vorelart.com
VOREX	vorex.com
VORMETRIC	vormetric.com
VORNADO	vornado.com
VOROFCO	vorofco.com
VORSANA	vorsana.com
VORSIGHT	vorsight.com
VORSITE	vorsite.com
VORTALA	vortala.com
VORTEGE	vortege.com
VOSAGO	vosago.com
VOSKY	vosky.com
VOSM	vosm.org
VOSSLOH	vossloh.com
VOTEC	votec.net
VOTERIDERS	voteriders.org
VOTERSNAP	votersnap.com
VOTETONYO	votetonyo.com
VOTIZEN	votizen.com
VOTOPIN	votopin.com
VOUCH	vouch.com
VOUCHERRY	voucherry.com
VOUDOO	voudoo.net
VOURNO	vourno.com
VOXA	voxa.com
VOXANT	voxant.com
VOXBEAM	voxbeam.com
VOXBONE	voxbone.com
VOXCOMP	voxcomp.com
VOXEET	voxeet.com
VOXENT	voxent.org
VOXEO	voxeo.com
VOXER	voxer.com
VOXGEN	voxgen.com
VOXGOV	voxgov.com
VOXITAS	voxitas.com
VOXIVA	voxiva.com
VOXMARKETING	voxmarketing.com
VOXOFON	voxofon.com
VOXOX	voxox.com
VOXPERITUS	voxperitus.com
VOXPOPNJ	voxpopnj.com
VOXWARE	voxware.com
VOXXI	voxxi.com
VOXY	voxy.com
VOYAGERMED	voyagermed.com
VOYAGEURWEB	voyageurweb.com
VOYANTA	voyanta.com
VOYAT	voyat.com
VOYENCE	voyence.com
VOYST	voyst.com
VOYZE	voyze.com
VOZLATINO	vozlatino.com
VPAC	vpac.org
VPGLOBAL	vpglobal.com
VPIRG	vpirg.org
VPISYSTEMS	vpisystems.com
VPNE	vpne.com
VPNTRANET	vpntranet.com
VPPSA	vppsa.com
VPQHC	vpqhc.org
VPRGROUP	vprgroup.net
VREINC	vreinc.com
VRINGO	vringo.com
VROOMEO	vroomeo.com
VRSIM	vrsim.net
VRTEAM	vrteam.com
VRTECH	vrtech.biz
VRVCO	vrvco.com
VSAC	vsac.org
VSANDBOX	vsandbox.com
VSBN	vsbn.org
VSCPR	vscpr.com
VSDGROUP	vsdgroup.com
VSDS	vsds.net
VSE	vse.com
VSEA	vsea.com
VSFCD	vsfcd.com
VSGI	vsgi.com
VSHIFT	vshift.com
VSIXDESIGN	vsixdesign.com
VSNAP	vsnap.com
VSOLVIT	vsolvit.com
VSP	vsp.com
VSYNC	vsync.com
VTA	vta.com
VTA	vta.org
VTB	vtb.com
VTDIGGER	vtdigger.org
VTEC	vtec.org
VTLS	vtls.com
VTMILCOM	vtmilcom.com
VTRIT	vtrit.com
VUBIQ	vubiq.com
VUBIZ	vubiz.com
VUCLIP	vuclip.com
VUEFOLIO	vuefolio.com
VUEMED	vuemed.com
VUEMIX	vuemix.com
VUESOCIETY	vuesociety.com
VUETURA	vuetura.com
VUGURU	vuguru.com
VULCAN	vulcan.com
VULCANAMPS	vulcanamps.com
VULCANPOINT	vulcanpoint.com
VULUME	vulume.com
VUMBLE	vumble.com
VUMBRELLA	vumbrella.com
VUMEDI	vumedi.com
VUMII	vumii.com
VUNGLE	vungle.com
VUNIFY	vunify.com
VUNITY	vunity.com
VUPS	vups.org
VURCHASE	vurchase.com
VURIA	vuria.com
VURV	vurv.com
VUSION	vusion.net
VUZIX	vuzix.com
VVAUDIO	vvaudio.com
VVISD	vvisd.org
VVISIBLE	vvisible.com
VW	vw.com
VWCGLOBAL	vwcglobal.com
VWORKER	vworker.com
VWR	vwr.com
VWV	vwv.com
VYGON	vygon.com
VYKE	vyke.com
VYPE	vype.com
VYPERSIM	vypersim.com
VYRE	vyre.com
VYRIAN	vyrian.com
VYTEK	vytek.com
VZAZZ	vzazz.com
VZURE	vzure.com
W2A	w2a.com
W2WLINK	w2wlink.com
W3BG	w3bg.com
W3GLOBAL	w3global.com
W4	w4.com
MBFBIOSCIENCE	mbfbioscience.com
MBH	mbh.com
MBHB	mbhb.com
MBHSTUDIOS	mbhstudios.com
MBI	mbi.org
MBIA	mbia.com
MBL	mbl.edu
MBLAST	mblast.com
MBLM	mblm.com
MBLOX	mblox.com
MBM	mbm.com
MBNLP	mbnlp.com
MBREPORTING	mbreporting.com
MBS	mbs.com
MBTA	mbta.com
MBTECH	mbtech.com
MBUAPCD	mbuapcd.org
MBUDESIGNS	mbudesigns.net
MBUY	mbuy.com
MCACONNECT	mcaconnect.net
MCAFEE	mcafee.com
MCALVAIN	mcalvain.com
MCARLSONDESIGNS	mcarlsondesigns.com
MCARRONWEBDESIGN	mcarronwebdesign.com
MCASD	mcasd.org
MCATDESIGN	mcatdesign.com
MCAWORKS	mcaworks.com
MCBA	mcba.com
MCBE	mcbe.net
MCBOSS	mcboss.net
MCCAC	mccac.com
MCCAFFERTY-WHITTLE	mccafferty-whittle.com
MCCAIN	mccain.com
MCCALLARIOS	mccallarios.com
MCCANN	mccann.com
MCCARTAN	mccartan.com
MCCARTHY	mccarthy.com
MCCARTHYSITES	mccarthysites.com
MCCC	mccc.edu
MCCG	mccg.net
MCCG	mccg.org
MCCHAMBERMUSIC	mcchambermusic.com
MCCHC	mcchc.org
MCCLONE	mcclone.com
MCCM	mccm.org
MCCOLLY	mccolly.com
MCCORMICK	mccormick.com
MCCROMETER	mccrometer.com
MCCSC	mccsc.edu
MCCSD	mccsd.org
MCCUBBIN	mccubbin.com
MCDAVIDUSA	mcdavidusa.com
MCDERMOTT	mcdermott.com
MCDERMOTTCOSTA	mcdermottcosta.com
MCDEVCO	mcdevco.org
MCE	mce.com
MCERGO	mcergo.com
MCFA	mcfa.com
MCFI	mcfi.net
MCG	mcg.edu
MCGARD	mcgard.com
MCGARRYBOWEN	mcgarrybowen.com
MCGB	mcgb.com
MCGEAN	mcgean.com
MCGINTECH	mcgintech.com
MCGLADREY	mcgladrey.com
MCGOUGH	mcgough.com
MCGRAW-HILL	mcgraw-hill.com
MCGRIFF	mcgriff.com
MCGUIREWOODS	mcguirewoods.com
MCHC	mchc.com
MCHS	mchs.com
MCHS	mchs.net
MCHUTCHISON	mchutchison.com
MCIC	mcic.org
MCINSIGHTSINC	mcinsightsinc.com
MCJUNKIN	mcjunkin.com
MCKELLA280	mckella280.com
MCKENNA	mckenna.org
MCKENZIEHR	mckenziehr.com
MCKESSON	mckesson.com
MCKILLICAN	mckillican.com
MCKINLEY	mckinley.com
MCKINNEY	mckinney.com
MCKINNONS	mckinnons.org
MCKINSEY	mckinsey.com
MCKINSTRY	mckinstry.com
MCKISSOCK	mckissock.com
MCLA	mcla.edu
MCLAGAN	mclagan.com
MCLEANPHOTO	mcleanphoto.com
MCLEODUSA	mcleodusa.com
MCLOONE	mcloone.com
MCMCA	mcmca.org
MCMH	mcmh.org
MCMILLANDOOLITTLE	mcmillandoolittle.com
MCNC	mcnc.org
MCNEARY	mcneary.com
MCNETT	mcnett.com
MCNICHOLS	mcnichols.com
MCNYC	mcnyc.com
MCOL	mcol.com
MCPC	mcpc.com
MCPHERSONS	mcphersons.com
MCPHS	mcphs.edu
MCPIFILM	mcpifilm.com
MCPN	mcpn.org
MCPRODUCTION	mcproduction.com
MCRA	mcra.com
MCREL	mcrel.org
MCTEXPERT	mctexpert.com
MCTRAX	mctrax.com
MCTS	mcts.com
MCVB	mcvb.org
MCVEAN	mcvean.com
MCVET	mcvet.org
MCW	mcw.edu
MCWA	mcwa.com
MCWATERS	mcwaters.com
MCWE	mcwe.com
MCWHINNEY	mcwhinney.com
MCWILLIAMSBALLARD	mcwilliamsballard.com
MCXESS	mcxess.com
MCYAWN	mcyawn.com
MCYO	mcyo.org
MD247	md247.com
MD2U	md2u.com
MD7	md7.com
MDA	mda.mil
MDABSTRACT	mdabstract.com
MDADMIT	mdadmit.com
MDALLC	mdallc.net
MDB	mdb.org
MDC	mdc.edu
TWD	twd.com
TWEAKNUT	tweaknut.com
TWEC	twec.biz
TWEEDMEDIA	tweedmedia.com
TWEEKABOO	tweekaboo.com
TWEEPAR	tweepar.com
TWEETMYJOBS	tweetmyjobs.com
TWEETSICLES	tweetsicles.com
TWEHOUS	twehous.com
TWELVE23	twelve23.com
TWELVE56CREATIVE	twelve56creative.com
TWELVEFOLD	twelvefold.com
TWENTIETH	twentieth.net
TWENTY20BANCARD	twenty20bancard.com
TWENTYANDSEVEN	twentyandseven.com
TWENTYPINE	twentypine.com
TWENTYTH	twentyth.com
TWIDDY	twiddy.com
TWILIO	twilio.com
TWILOPR	twilopr.com
TWINDOM	twindom.com
TWINENGINE	twinengine.com
TWINFINITE	twinfinite.net
TWINKIEBABIES	twinkiebabies.com
TWINLAB	twinlab.com
TWINLODE	twinlode.com
TWINPOOL	twinpool.com
TWINSTRATA	twinstrata.com
TWINTAILS	twintails.com
TWIRLYBYRD	twirlybyrd.com
TWIST	twist.com
TWISTHINK	twisthink.com
TWISTNSHOUT	twistnshout.com
TWISTSIX	twistsix.com
TWLC	twlc.org
TWOBOLT	twobolt.com
TWOBULLS	twobulls.net
TWOFOUR	twofour.com
TWOFOUR54	twofour54.com
TWONGO	twongo.com
TWONIL	twonil.com
TWOTONEUMBRELLA	twotoneumbrella.com
TWR	twr.org
TWRU	twru.com
TWSCO	twsco.com
TWSQUARED	twsquared.com
TWTELECOM	twtelecom.com
TWTMOB	twtmob.com
TWU	twu.edu
TWUNI	twuni.net
TWYLAH	twylah.com
TXCDC	txcdc.com
TXI	txi.com
TXODDJOBS	txoddjobs.com
TXT2LOOK	txt2look.com
TXTBOOKRENTAL	txtbookrental.com
TXTMOVIES	txtmovies.com
TXTWATCHER	txtwatcher.com
TXU	txu.com
TXVIA	txvia.com
TYBA	tyba.com
TYCOELECTRONICS	tycoelectronics.com
TYDENBRAMMALL	tydenbrammall.com
TYEMILL	tyemill.com
TYKOON	tykoon.com
TYLERS	tylers.net
TYLESS	tyless.com
TYLOON	tyloon.com
TYMPANI	tympani.net
TYNANS	tynans.com
TYNAX	tynax.com
TYNKER	tynker.com
TYPEHAUS	typehaus.com
TYPEMOCK	typemock.com
TYPETHINK	typethink.com
TYPEWELL	typewell.com
TYRATECH	tyratech.com
TYRRELLTECH	tyrrelltech.com
TYSON	tyson.com
TYTEX	tytex.com
TZEE	tzee.com
TZELL	tzell.com
TZUMI	tzumi.com
TZUNAMI	tzunami.com
U-STORIT	u-storit.com
U2I	u2i.com
U41	u41.org
UA4YOU	ua4you.net
UAACOG	uaacog.com
UAAMUSIC	uaamusic.org
UAB	uab.edu
UACCM	uaccm.edu
UAF	uaf.edu
UAH	uah.edu
UALR	ualr.edu
UAMC	uamc.com
UAMPS	uamps.com
UAMS	uams.com
UAMS	uams.edu
UANT	uant.com
UAPB	uapb.edu
UAPRESENTS	uapresents.org
UARK	uark.edu
UARS	uars.net
UAS	uas.com
UATEL	uatel.com
UAUTOBEE	uautobee.com
UBATC	ubatc.org
UBBLIST	ubblist.com
UBCSOFT	ubcsoft.com
UBELONG	ubelong.org
UBERCONFERENCE	uberconference.com
UBEREX	uberex.org
UBERGIZMO	ubergizmo.com
UBERMEDIA	ubermedia.com
UBERMEMORIALS	ubermemorials.com
UBEROFFICES	uberoffices.com
UBERSMITH	ubersmith.com
UBERSTIX	uberstix.com
UBERSYNC	ubersync.com
UBERTESTERS	ubertesters.com
UBERVU	ubervu.com
UBICOM	ubicom.com
UBICS	ubics.com
UBIDYNE	ubidyne.com
UBIMED	ubimed.com
UBIOME	ubiome.com
UBIQUBE	ubiqube.com
UBIQUIA	ubiquia.com
UBIQUIMEDIA	ubiquimedia.net
UBIQUITY	ubiquity.net
UBISENSE	ubisense.net
UBITUS	ubitus.net
UBIVAC	ubivac.com
UBIZWEB	ubizweb.com
UBLA	ubla.com
UBM	ubm.com
UBMATRIX	ubmatrix.com
UBNICE	ubnice.org
UBNSOFT	ubnsoft.com
UBOC	uboc.com
UBOKIA	ubokia.com
UBOOLY	ubooly.com
UBOON2	uboon2.com
UBP	ubp.com
UBREAKIFIX	ubreakifix.com
UBS	ubs.com
UBSNA	ubsna.com
UBUYCOFFEE	ubuycoffee.com
UC	uc.edu
UCA	uca.edu
UCAR	ucar.edu
UCARE	ucare.org
UCAS	ucas.com
UCB	ucb.com
UCCS	uccs.edu
UCCU	uccu.com
UCDAVIS	ucdavis.edu
UCDENVER	ucdenver.edu
UCEDC	ucedc.com
UCERA	ucera.org
UCF	ucf.edu
UCFM	ucfm.org
UCFS	ucfs.net
UCG	ucg.com
UCHC	uchc.edu
UCHIC	uchic.com
UCHSC	uchsc.edu
UCI	uci.edu
UCLA	ucla.edu
UCOMPAREHEALTHCARE	ucomparehealthcare.com
UCONFIRM	uconfirm.com
UCONN	uconn.edu
UCONNECTHOME	uconnecthome.com
UCOOL	ucool.com
UCOP	ucop.edu
UCPA	ucpa.com
UCPB	ucpb.com
UCR	ucr.edu
UCRAVE	ucrave.com
UCSB	ucsb.edu
UCSC	ucsc.edu
UCSD	ucsd.edu
UCSF	ucsf.edu
UCSG	ucsg.com
UCSJ	ucsj.org
UCT	uct.com
UCVIEW	ucview.com
UDACITY	udacity.com
UDC	udc.edu
UDC	udc.net
UDECON	udecon.com
UDELHOVEN	udelhoven.com
UDELLDIRECT	udelldirect.com
UDEMY	udemy.com
UDEVELOPME	udevelopme.com
UDIG	udig.com
UDMUN	udmun.com
UDP	udp.com
UDR	udr.com
UDRC	udrc.biz
UDSD	udsd.org
UDSMR	udsmr.org
UDUNDI	udundi.com
UDWELL	udwell.com
UEFA	uefa.org
UEMSI	uemsi.com
UERPC	uerpc.org
UESF	uesf.org
UESI	uesi.com
UESP	uesp.org
UEVEN	ueven.com
UFAKER	ufaker.com
UFCW	ufcw.org
UFF	uff.net
UFOLLOWIT	ufollowit.com
UFONE	ufone.com
UFORA	ufora.com
UFPC	ufpc.com
UFPI	ufpi.com
UG2	ug2.com
UGA	uga.edu
UGI	ugi.com
UGIVE	ugive.org
UGOBE	ugobe.com
UGOVERNIT	ugovernit.com
UGS	ugs.com
UH	uh.edu
UHAB	uhab.org
UHAUL	uhaul.com
UHBER	uhber.com
UHC	uhc.com
UHC	uhc.edu
UHD	uhd.com
UHEAA	uheaa.org
UHEALTHSOLUTIONS	uhealthsolutions.org
UHMMS	uhmms.com
UHY	uhy.com
UIC	uic.edu
UIC	uic.org
UICFC	uicfc.org
UIEVOLUTION	uievolution.com
UIP	uip.com
UIQ	uiq.com
UISCEDWR	uiscedwr.com
UISOL	uisol.com
UIUC	uiuc.edu
UJAM	ujam.com
UJFC	ujfc.org
UJOINER	ujoiner.com
UJOURNEY	ujourney.com
UL	ul.com
ULBRICH	ulbrich.com
ULI	uli.org
ULIKEIT	ulikeit.com
ULINE	uline.com
ULINGO	ulingo.com
ULLICO	ullico.com
ULLINK	ullink.com
ULM	ulm.edu
ULOOP	uloop.com
ULOVEI	ulovei.com
ULTA	ulta.com
ULTCOMP	ultcomp.com
ULTEIG	ulteig.com
ULTHERA	ulthera.com
ULTICOM	ulticom.com
ULTIMATEAIR	ultimateair.com
ULTIMATEGRASS	ultimategrass.com
ULTIMUS	ultimus.com
ULTISAT	ultisat.com
ULTIWORLD	ultiworld.com
ULTRA-FAB	ultra-fab.com
ULTRA-SPECTIVE	ultra-spective.com
ULTRABASE	ultrabase.net
ULTRABLAND	ultrabland.com
ULTRABULK	ultrabulk.com
ULTRACLEAR	ultraclear.com
ULTRADENT	ultradent.com
ULTRADESIGNS	ultradesigns.com
ULTRADNS	ultradns.com
ULTRAECHO	ultraecho.com
ULTRAFAB	ultrafab.com
ULTRALINGUA	ultralingua.com
ULTRAMEDICALS	ultramedicals.com
ULTRASHIPTMS	ultrashiptms.com
ULTRASTOR	ultrastor.com
ULTRASUDS	ultrasuds.com
ULTRATECH	ultratech.com
ULTRAVATION	ultravation.com
ULTRAVISUAL	ultravisual.com
ULTREO	ultreo.com
ULTRIVA	ultriva.com
ULYFE	ulyfe.com
UMACHA	umacha.org
UMAI	umai.com
UMAMIE	umamie.com
UMANIS	umanis.com
UMARKETING	umarketing.com
UMB	umb.com
UMBC	umbc.edu
UMBRA	umbra.com
UMBRELLIBLE	umbrellible.com
UMBRO	umbro.com
UMCOM	umcom.org
WAHANDA	wahanda.com
WAHLCOMETROFLEX	wahlcometroflex.com
WAHLSTROM	wahlstrom.com
WAHMA	wahma.net
WAI-WIZE	wai-wize.com
WAIDENT	waident.com
WAITBOT	waitbot.com
WAITRAINER	waitrainer.com
WAKEFERN	wakefern.com
WAKEFLY	wakefly.com
WAKEIO	wakeio.com
WAKEMED	wakemed.org
WAKEUPGETHEALTHY	wakeupgethealthy.com
WAKEUPSTAR	wakeupstar.com
WAKODA	wakoda.com
WAL-MART	wal-mart.com
WAL-TECH	wal-tech.com
WALBRIDGE	walbridge.com
WALBRO	walbro.com
WALCHEM	walchem.com
WALGREENS	walgreens.com
WALK2CONNECT	walk2connect.com
WALK2WIN	walk2win.org
WALKBOSTON	walkboston.org
WALKCON	walkcon.com
WALKER360	walker360.com
WALKERDANIELS	walkerdaniels.com
WALKERFX	walkerfx.com
WALKJOGRUN	walkjogrun.net
WALKME	walkme.com
WALKSACRAMENTO	walksacramento.org
WALKSOURCE	walksource.com
WALKSTYLES	walkstyles.com
WALLAMEDIA	wallamedia.com
WALLETHUB	wallethub.com
WALLIES	wallies.com
WALLMUSE	wallmuse.com
WALLPAPERPRO	wallpaperpro.com
WALLPLAY	wallplay.com
WALLPROTEX	wallprotex.com
WALLSTREETOASIS	wallstreetoasis.com
WALLYPARK	wallypark.com
WALMAN	walman.com
WALMART	walmart.com
WALRUSINK	walrusink.com
WALSER	walser.com
WALSINGHAM	walsingham.org
WALSWORTH	walsworth.com
WALTCO	waltco.com
WALTERCREATIVE	waltercreative.com
WALTERLEGAL	walterlegal.com
WALTERSGROUP	waltersgroup.com
WALTONEN	waltonen.com
WALTRANS	waltrans.com
WALZCRAFT	walzcraft.com
WAMBATECH	wambatech.com
WAMC	wamc.com
WAMC	wamc.org
WAMHOFF	wamhoff.com
WAMMIN	wammin.com
WAMOYO	wamoyo.com
WAMPUMM	wampumm.com
WAMU	wamu.net
WANDERABLE	wanderable.com
WANDERART	wanderart.org
WANDERBIKES	wanderbikes.com
WANDERLED	wanderled.com
WANDERLESS	wanderless.com
WANDL	wandl.com
WANELO	wanelo.com
PAYCHEX	paychex.com
PAYCHOICE	paychoice.com
PAYCOR	paycor.com
PAYCYCLE	paycycle.com
PAYDAYPERX	paydayperx.com
PAYDAYR	paydayr.com
PAYDC	paydc.com
PAYDIANT	paydiant.com
PAYDOGS	paydogs.com
PAYDQ	paydq.com
PAYETTE	payette.com
PAYEX	payex.com
PAYFACTORS	payfactors.com
PAYFLEX	payflex.com
PAYFONE	payfone.com
PAYJUNCTION	payjunction.com
PAYLEAP	payleap.com
PAYLEASE	paylease.com
PAYLESS	payless.com
PAYLESSNOW	paylessnow.com
PAYLESSOTC	paylessotc.com
PAYLIANCE	payliance.com
PAYLOCITY	paylocity.com
PAYMENTEZ	paymentez.com
PAYMENTMAX	paymentmax.com
PAYMENTSMD	paymentsmd.com
PAYMENTSPRING	paymentspring.com
PAYMENTUS	paymentus.com
PAYMENTVISION	paymentvision.com
PAYMETRIC	paymetric.com
PAYMUNDI	paymundi.com
PAYNEARME	paynearme.com
PAYNORTHWEST	paynorthwest.com
PAYODA	payoda.com
PAYONE	payone.com
PAYONEER	payoneer.com
PAYPAL	paypal.com
PAYPANTHER	paypanther.com
PAYPAY	paypay.com
PAYPLUM	payplum.com
PAYPOYNT	paypoynt.net
PAYPROS	paypros.com
PAYPROTEC	payprotec.com
PAYRANGE	payrange.com
PAYROLLCENTRIC	payrollcentric.com
PAYSIMPLE	paysimple.com
PAYSOUTH	paysouth.com
PAYSTAND	paystand.com
PAYSTUBZ	paystubz.com
PAYTRACE	paytrace.com
PAYVERIS	payveris.com
PAYVIO	payvio.com
PAYVISION	payvision.com
PAYVISORS	payvisors.com
PAYVMENT	payvment.com
PAYWITHMYBANK	paywithmybank.com
PAZENLAW	pazenlaw.com
PBBOR	pbbor.org
PBD	pbd.com
PBGC	pbgc.gov
PBGD	pbgd.com
PBIRX	pbirx.com
PBJS	pbjs.com
PBK	pbk.com
PBNB	pbnb.net
XCELENERGY	xcelenergy.com
XCELIGENT	xceligent.com
XCELIWARE	xceliware.com
XCELLARANT	xcellarant.com
XCELLEREX	xcellerex.com
XCELLIGENT	xcelligent.com
XCELLIMARK	xcellimark.com
XCELOGIC	xcelogic.com
XCELPROS	xcelpros.com
XCELUS	xcelus.com
XCELUTIONS	xcelutions.com
XCENDA	xcenda.com
XCENT	xcent.com
XCENTRIC	xcentric.com
XCENTRICITIES	xcentricities.com
XCERION	xcerion.com
XCHANGETEAM	xchangeteam.com
XCHEMA	xchema.com
XCLMARK	xclmark.com
XCLSOFT	xclsoft.com
XCONNECT	xconnect.net
XCONOMY	xconomy.com
XCOVERY	xcovery.com
XDEVGROUP	xdevgroup.com
XDREAMUSA	xdreamusa.com
XDTI	xdti.com
XDX	xdx.com
XDYNIA	xdynia.com
XEBIA	xebia.com
XEBIALABS	xebialabs.com
XEBRATECH	xebratech.com
XEBRAWERX	xebrawerx.com
XELACOMP	xelacomp.com
XELERATED	xelerated.com
XELLERATION	xelleration.com
XELR8	xelr8.com
XELTEK	xeltek.com
XEMBEDDED	xembedded.com
XENCOR	xencor.com
XENITH	xenith.com
XENMATCH	xenmatch.com
XENOLYTIX	xenolytix.com
XENOMORPH	xenomorph.com
XENOTRAN	xenotran.com
XENTRAIN	xentrain.com
XERAFY	xerafy.com
XERAGO	xerago.com
XERILLION	xerillion.com
XERIMETRICS	xerimetrics.com
XEROGRAPHICS	xerographics.com
XERORIP	xerorip.com
XEROSOLAR	xerosolar.com
XEROX	xerox.com
XETA	xeta.com
XETAWAVE	xetawave.com
XEXEC	xexec.com
XFIRE	xfire.com
XFORMA	xforma.com
XGILITY	xgility.com
XHATCH	xhatch.com
XHTMLJUNKIES	xhtmljunkies.com
XIBEO	xibeo.com
XIBITZ	xibitz.com
XIGNITE	xignite.com
XIGO	xigo.com
XILINX	xilinx.com
XIMAD	ximad.com
XIMEDICA	ximedica.com
XINDAO	xindao.com
XINGRAPHICS	xingraphics.com
XINNOVIT	xinnovit.com
XINYISOFT	xinyisoft.com
XIOLINK	xiolink.com
XIPLINK	xiplink.com
XIRRUS	xirrus.com
XITRON	xitron.com
XK9	xk9.com
XKAST	xkast.com
XKZERO	xkzero.com
XLA	xla.com
XLANZ	xlanz.com
XLCAD	xlcad.com
XLCON	xlcon.com
XLEMR	xlemr.com
XLESSONS	xlessons.com
XLHEALTH	xlhealth.com
XLHOST	xlhost.com
XLNSYSTEMS	xlnsystems.com
XLNTADS	xlntads.com
XLR8R	xlr8r.com
XMARTEK	xmartek.com
XMISSION	xmission.com
XMLFUND	xmlfund.com
XMODDZ	xmoddz.com
XMPIE	xmpie.com
XMSTART	xmstart.com
XMULTIPLE	xmultiple.com
XNERGY	xnergy.com
XNETXSYS	xnetxsys.com
XO	xo.com
XO3MEDIA	xo3media.com
XOBAL	xobal.net
XOCAI	xocai.com
XOCOMP	xocomp.com
XOFTWEE	xoftwee.com
XOJET	xojet.com
XOLOGIC	xologic.com
XOMA	xoma.com
XONICWAVE	xonicwave.com
XONUOX	xonuox.com
XOOM	xoom.com
XOOMAWORLDWIDE	xoomaworldwide.com
XORCO	xorco.com
XORIANT	xoriant.com
XORLOGICS	xorlogics.com
XOS	xos.com
XOTAR	xotar.com
XOTERIK	xoterik.com
XOVERAUDIO	xoveraudio.com
XOXOPUBLISHING	xoxopublishing.com
XOXOSWEDEN	xoxosweden.com
XPANXION	xpanxion.com
XPDENT	xpdent.com
XPEC	xpec.com
XPEDESIGN	xpedesign.com
XPEDITE	xpedite.com
XPEDIUM	xpedium.com
XPEDX	xpedx.com
XPEERANT	xpeerant.com
XPENSER	xpenser.com
XPERACTIVE	xperactive.com
XPERIENCE4HIGHER	xperience4higher.com
XPERIENCELAB	xperiencelab.com
XPERIENT	xperient.com
XPERIOR	xperior.com
XPERTIKUS	xpertikus.com
XPLANE	xplane.com
XPLORIT	xplorit.com
XPOSLINE	xposline.com
XPRESSBIO	xpressbio.com
XPRESSCREEN	xpresscreen.com
XPRESSDOCS	xpressdocs.com
XPRESSPA	xpresspa.com
XPRESSPLAY	xpressplay.com
XPRESSRATE	xpressrate.com
XPRESSTEKS	xpressteks.com
XPRESTUDIOS	xprestudios.com
XPRIORI	xpriori.com
XPRIZE	xprize.org
XPRUDENT	xprudent.com
XPWEBDESIGNERS	xpwebdesigners.com
XRADIANZ	xradianz.com
XRAZE	xraze.com
XRECORDS	xrecords.biz
XRMD	xrmd.com
XSB	xsb.com
XSIMPLE	xsimple.com
XSIVE1	xsive1.com
XSMANIACOS	xsmaniacos.com
XSOLLA	xsolla.com
XSP	xsp.com
XSPLATFORMS	xsplatforms.com
XSPOND	xspond.com
XSPORTSPROTECTIVE	xsportsprotective.com
XSQUALITY	xsquality.com
XSTREAM	xstream.net
XSURA	xsura.com
XSYNESIS	xsynesis.com
XTAR	xtar.com
XTEGO	xtego.com
XTEK	xtek.com
XTEND	xtend.com
XTENDACOMS	xtendacoms.com
XTENDWAVE	xtendwave.com
XTENSIO	xtensio.com
XTERPRISE	xterprise.com
XTIME	xtime.com
XTIUM	xtium.com
XTIVIA	xtivia.com
XTRA	xtra.com
XTRAICE	xtraice.com
XTRALIS	xtralis.com
XTRALOCK	xtralock.com
XTRAOUTLET	xtraoutlet.com
XTRATEGIES	xtrategies.com
XTREMETRIM	xtremetrim.com
XTREMEYOGURT	xtremeyogurt.com
XTRII	xtrii.com
XTRUDEX	xtrudex.com
XTRUDX	xtrudx.com
XTUPLE	xtuple.com
XUARE	xuare.com
XUBER	xuber.com
XUBEX	xubex.com
XUIS	xuis.com
XUMAK	xumak.com
XUMO	xumo.com
XUREX	xurex.com
XURTLE	xurtle.com
XVIO	xvio.com
XVIONICS	xvionics.com
XVIVO	xvivo.net
XVOLVE	xvolve.com
XWALKER	xwalker.com
XWAVE	xwave.com
XXLGAMING	xxlgaming.com
XXPLORE	xxplore.org
XXPRESSFUNDING	xxpressfunding.com
XXXRXRR	xxxrxrr.com
XYCUBED	xycubed.com
XYFER	xyfer.com
XYLEME	xyleme.com
XYLLABUS	xyllabus.com
XYNMANAGEMENT	xynmanagement.com
XYNQO	xynqo.com
XYPEX	xypex.com
XYPRO	xypro.com
XYRON	xyron.com
XYXONLINE	xyxonline.com
XZAMCORP	xzamcorp.com
XZONE9	xzone9.com
XZYTED	xzyted.com
Y-NOT	y-not.com
Y2KSOLUTIONS	y2ksolutions.com
Y5ZONE	y5zone.net
YABT	yabt.net
YACHT1CHICAGO	yacht1chicago.com
YACHTPRO	yachtpro.com
YACHTS4FUN	yachts4fun.com
YACHTSPLUS	yachtsplus.com
YACHTZOO	yachtzoo.com
YADON	yadon.com
YAGERSHOTS	yagershots.com
YAGNAUM	yagnaum.com
YAI	yai.org
YAK-TEK	yak-tek.com
YAKBLAK	yakblak.com
YALE	yale.edu
YAM112003	yam112003.com
YAMAHA	yamaha.com
YAMAZEN	yamazen.com
YAMCONI	yamconi.com
YAMEVEO	yameveo.com
YAMGROUP	yamgroup.com
YAMIBUY	yamibuy.com
YAMISEE	yamisee.com
YANKEESCENTS	yankeescents.com
YAPERT	yapert.com
YAPMO	yapmo.com
YAPPOINT2B	yappoint2b.com
YAPSTONE	yapstone.com
YAPTA	yapta.com
YAPTAP	yaptap.com
YARCO	yarco.com
YARD-N-GARD	yard-n-gard.com
YARDI	yardi.com
YARDSELLR	yardsellr.com
YARDVIEW	yardview.com
YAREWELL	yarewell.com
YARNXPRESS	yarnxpress.com
YASB	yasb.com
YASKAWA	yaskawa.com
YATBA	yatba.com
YATEDO	yatedo.com
YAVAY	yavay.net
YBI	ybi.com
YBOGGLE	yboggle.com
YBVISUAL	ybvisual.com
YCENTER	ycenter.org
YCHARTS	ycharts.com
YCLIN	yclin.net
YCN	ycn.org
YCNGA	ycnga.com
YCPARMIA	ycparmia.com
YDATUM	ydatum.com
YDRAW	ydraw.com
YEAHOYEAH	yeahoyeah.com
YEARBOOKMACHINE	yearbookmachine.com
YEELDR	yeeldr.com
YEHSS	yehss.com
YEKOM	yekom.com
YEKRA	yekra.com
YELCOT	yelcot.com
YELED	yeled.org
YELLDY	yelldy.com
YELLOW7	yellow7.com
YELLOWBERRI	yellowberri.com
YELLOWBOOK	yellowbook.com
YELLOWBRIX	yellowbrix.com
YELP	yelp.com
YEMENIA	yemenia.com
YENTUP	yentup.com
YEOUSCH	yeousch.com
YERDLE	yerdle.com
YESANIME	yesanime.com
YESBRACES	yesbraces.com
YESCFO	yescfo.com
YESCO	yesco.com
YESDESIGN	yesdesign.org
YESDESIGNGROUP	yesdesigngroup.com
YESEVENTS	yesevents.com
YESFAITH	yesfaith.com
YESIMO	yesimo.com
YESLER	yesler.com
YESMAIL	yesmail.com
YESPAC	yespac.com
YESPAY	yespay.com
YESPHILLY	yesphilly.org
YESQUIRE	yesquire.com
YESTRAK	yestrak.com
YESVIDEO	yesvideo.com
YESWARE	yesware.com
YESYESVI	yesyesvi.com
YESYOUS	yesyous.com
YETISPACE	yetispace.com
YEXT	yext.com
YHPE	yhpe.org
NOBILICO	nobilico.com
NOBLE	noble.net
NOBLEASSIST	nobleassist.com
NOBLELOGIC	noblelogic.net
NOBLEMEDIATION	noblemediation.com
NOBLESAVAGE	noblesavage.com
NOBLETEK	nobletek.com
NOBLIS	noblis.org
NOBODYPANIC	nobodypanic.com
NOBODYSUGLY	nobodysugly.com
NOBOSH	nobosh.com
NOBOX	nobox.com
NOBUFILM	nobufilm.com
NOCADO	nocado.com
NOCATEE	nocatee.com
NOCCA	nocca.com
NOCCR	noccr.com
NOCO	noco.com
NOCOSTCOUPONS	nocostcoupons.com
NOCTI	nocti.org
NODEPOSITCARINSURANCEQUOTE	nodepositcarinsurancequote.com
NODEPRIME	nodeprime.com
NOESIS	noesis.net
NOETICUS	noeticus.org
NOFAVORITE	nofavorite.com
NOFRILL	nofrill.com
NOGGINAUT	nogginaut.com
NOGGINLABS	nogginlabs.com
NOGGINWOK	nogginwok.com
NOGOYO	nogoyo.com
NOIPM	noipm.com
NOISEFLOOR	noisefloor.com
NOISENY	noiseny.com
NOISETREND	noisetrend.com
NOIZYLADY	noizylady.com
NOKIA	nokia.com
NOKODA	nokoda.com
NOKONA	nokona.com
NOLAGALLERIE	nolagallerie.com
NOLAGRAPHICS	nolagraphics.com
NOLALOCAVORES	nolalocavores.org
NOLANVISION	nolanvision.com
NOLCHA	nolcha.com
NOLDERMEDIA	noldermedia.com
NOLIJ	nolij.com
NOLO	nolo.com
NOLTEX	noltex.com
NOM	nom.com
NOMAC	nomac.com
NOMACHINE	nomachine.com
NOMACO	nomaco.com
NOMACORC	nomacorc.com
NOMADDIC	nomaddic.com
NOMADEDITIONS	nomadeditions.com
NOMADGARDENS	nomadgardens.org
NOMADICFROG	nomadicfrog.com
NOMADIO	nomadio.net
NOMADIQUE	nomadique.com
NOMATERRA	nomaterra.com
NOMATIME	nomatime.com
NOMATX	nomatx.com
NOMBAT	nombat.com
NOMEN	nomen.com
NOMIC	nomic.com
NOMIKU	nomiku.com
NOMISE	nomise.com
NOMMA	nomma.org
NOMMESEN	nommesen.com
NOMOLDATLANTA	nomoldatlanta.com
NOMON	nomon.com
NOMORECLIPBOARD	nomoreclipboard.com
NOMURA	nomura.com
NONABROOKLYN	nonabrooklyn.com
NONADECIMAL	nonadecimal.com
NONBOX	nonbox.com
NONCHALANCE	nonchalance.com
NONEART	noneart.com
NONEG101	noneg101.com
NONEIS	noneis.com
NONEKO	noneko.com
NONESUCHTHINGS	nonesuchthings.com
NONOBJECT	nonobject.com
NONOTUCK	nonotuck.com
NONPROFITEASY	nonprofiteasy.com
NONSENSEGAMER	nonsensegamer.com
NONSOCIETY	nonsociety.com
NONSPEC	nonspec.org
NONSTOPCONSULTING	nonstopconsulting.net
NONSTOPHR	nonstophr.com
NOOBIS	noobis.com
NOOCH	nooch.com
NOOKA	nooka.com
NOOKLYN	nooklyn.com
NOOKSEE	nooksee.com
NOOKSTER	nookster.com
NOOKWIT	nookwit.com
NOONANARTS	noonanarts.com
NOONANWORKS	noonanworks.com
NOORISH	noorish.com
NOPA	nopa.org
NOQUBE	noqube.com
NOR-TECH	nor-tech.com
NOR1	nor1.com
NORACOM	noracom.com
NORANDEX	norandex.com
NORBELLA	norbella.com
NORBEST	norbest.com
NORCHAR	norchar.com
NORCIMBUS	norcimbus.com
NORCOLD	norcold.com
NORCOMM	norcomm.net
NORCOMP	norcomp.com
NORCOSGO	norcosgo.com
NORDAM	nordam.com
NORDCO	nordco.com
NORDFAB	nordfab.com
NORDGOLD	nordgold.com
NORDICA	nordica.com
NORDICWARE	nordicware.com
NORDION	nordion.com
NORDOST	nordost.com
NORDSON	nordson.com
NORDSTROM	nordstrom.com
NORDYNE	nordyne.com
NOREPLY	noreply.com
NORESCO	noresco.com
NORFIELD	norfield.com
NORFOLKSNYC	norfolksnyc.com
NORIBACHI	noribachi.com
NORIDIAN	noridian.com
NORIS	noris.org
NORITZ	noritz.com
NORKEM	norkem.com
NORLIGHT	norlight.com
NORLINX	norlinx.com
NORLUXCORP	norluxcorp.com
NORMALTIVITY	normaltivity.com
NORMATIVE	normative.com
NORMI	normi.org
NORML	norml.org
NORR	norr.com
NORR11	norr11.com
NORRED	norred.com
NORRISEAL	norriseal.com
NORSCOT	norscot.com
NORTECH	nortech.org
NORTEL	nortel.com
NORTH	north.com
NORTH40CREATIVE	north40creative.com
NORTHAMPTONCOUNTY	northamptoncounty.org
NORTHBAY	northbay.org
NORTHCARE	northcare.com
NORTHCREST	northcrest.com
WOMANKNOWS	womanknows.com
WOMANSAFEHEALTH	womansafehealth.com
WOMEGO	womego.com
WOMENABLE	womenable.com
WOMENARTS	womenarts.org
WOMENBLOOM	womenbloom.com
WOMENCORPORATEDIRECTORS	womencorporatedirectors.com
WOMENKIND	womenkind.net
WOMENONCALL	womenoncall.org
WOMENRISING	womenrising.org
WOMENSAFE	womensafe.net
WOMENSJOBLIST	womensjoblist.com
WOMENSTRUST	womenstrust.org
WOMENVENTURE	womenventure.org
WOMONEY	womoney.com
WOMPLY	womply.com
WONDERBRED	wonderbred.com
WONDERLIC	wonderlic.com
WONDERMALL	wondermall.com
WONDERMAT	wondermat.com
WONDERMEDIA	wondermedia.com
WONDERWARE	wonderware.com
WONDERWORK	wonderwork.org
WONDRAGROUP	wondragroup.com
WONDRISKARUSSO	wondriskarusso.com
WONDROS	wondros.com
WONGDOODY	wongdoody.com
WONOLO	wonolo.com
WONOPOLY	wonopoly.org
WOODALERT	woodalert.com
WOODBINE	woodbine.com
WOODBROWSER	woodbrowser.com
WOODCRAFT	woodcraft.com
WOODGRAIN	woodgrain.com
WOODLANDSMOMMY	woodlandsmommy.com
WOODLINESOLUTIONS	woodlinesolutions.com
WOODLINK	woodlink.net
WOODLOCH	woodloch.com
WOODLYNPARTNERS	woodlynpartners.com
WOODMEN	woodmen.org
WOODNETWORKS	woodnetworks.com
WOODSAGE	woodsage.com
WOODSMITHE	woodsmithe.com
WOODTRUST	woodtrust.com
WOODTV	woodtv.com
WOODWARD	woodward.com
WOODWARDAUTO	woodwardauto.com
WOODWINDOWSINC	woodwindowsinc.com
WOODWORKS	woodworks.org
WOODWORKS4KIDS	woodworks4kids.com
WOOFOUND	woofound.com
WOOGA	wooga.com
WOOLPERT	woolpert.com
NEOTI	neoti.com
NEOTICK	neotick.com
NEOTOY	neotoy.com
NEOTRACT	neotract.com
NEOTYS	neotys.com
NEOUCOM	neoucom.edu
NEOVERA	neovera.com
NEOVERUS	neoverus.com
NEOVSP	neovsp.com
NEOZENE	neozene.com
NEPC	nepc.com
NEPHROLOGYUSA	nephrologyusa.com
NEPHROPATH	nephropath.com
NEPIRC	nepirc.com
NEPM	nepm.com
NEPTCO	neptco.com
NEPTI	nepti.com
NERAC	nerac.com
NERACOOS	neracoos.org
NERDBOTS	nerdbots.com
NERDLOCKER	nerdlocker.com
NERDMOTION	nerdmotion.com
NERDOGY	nerdogy.com
NERDONOMY	nerdonomy.com
NERDPHONE	nerdphone.net
NERDSOCIETY	nerdsociety.com
NERDTAP	nerdtap.com
NERDTOWN	nerdtown.com
NERDWALLET	nerdwallet.com
NERO	nero.net
NERVE2SERVE	nerve2serve.com
NERVOSA	nervosa.org
NESCAUM	nescaum.org
NESDA	nesda.com
NESIGN	nesign.com
NESN	nesn.com
NESPRA	nespra.com
NESPRESSO	nespresso.com
NESSIT	nessit.net
NESSNET	nessnet.com
NESST	nesst.org
NEST4LESS	nest4less.com
NESTGSV	nestgsv.com
NESTIO	nestio.com
NESTLE	nestle.com
NESTLEBERRY	nestleberry.com
NESTLIFE	nestlife.com
NET-AV	net-av.com
NET-SMART	net-smart.net
NET-SPIN	net-spin.com
NET1PLUS	net1plus.com
NET2APPS	net2apps.com
NET2MALLS	net2malls.net
NET2SKY	net2sky.com
NET2SOLUTIONS	net2solutions.com
NET2VAULT	net2vault.com
NET32	net32.com
NET4SITE	net4site.net
NET56	net56.com
NETACOM	netacom.com
NETADSOLUTIONS	netadsolutions.net
NETAGE	netage.com
NETALYTICS	netalytics.com
NETAPP	netapp.com
NETARX	netarx.com
NETBANK	netbank.com
NETBANKAUDIT	netbankaudit.com
NETBILITY	netbility.com
NETBLAZON	netblazon.com
NETBLAZR	netblazr.com
NETBOOSTER	netbooster.com
NETBOUNDARY	netboundary.com
NETBSD	netbsd.org
NETCAMPS	netcamps.com
NETCARRIER	netcarrier.com
NETCENERGY	netcenergy.com
NETCENTRA	netcentra.com
NETCENTRICS	netcentrics.com
NETCHANNELS	netchannels.com
NETCHEMIA	netchemia.com
NETCHOICE	netchoice.biz
NETCIRQ	netcirq.com
NETCLARITY	netclarity.net
NETCOM3	netcom3.com
NETCOMGROUP	netcomgroup.biz
NETCOMM2000	netcomm2000.net
NETCONX	netconx.net
NETCRACKER	netcracker.com
NETCRAFTERS	netcrafters.com
NETCURAS	netcuras.com
NETCUSTOMER	netcustomer.com
NETDEBT	netdebt.com
NETDEMICS	netdemics.com
NETDEPOSIT	netdeposit.com
NETDEVIL	netdevil.com
NETDILIGENCE	netdiligence.com
NETDIRECTMEDIA	netdirectmedia.com
NETDIRECTOR	netdirector.biz
NETDOCUMENTS	netdocuments.com
NETDOR	netdor.net
NETECS	netecs.com
ZEUSTEK	zeustek.com
ZEVEX	zevex.com
ZEVIA	zevia.com
ZEVRO	zevro.com
ZEVULUN	zevulun.com
ZEXSPORTS	zexsports.com
ZEZLY	zezly.com
ZF	zf.com
ZFPIT	zfpit.com
ZGDESIGN	zgdesign.com
ZGF	zgf.com
ZHEPHREE	zhephree.com
ZHUNRIZE	zhunrize.com
ZHUROSOFT	zhurosoft.com
ZIASAT	ziasat.com
ZIDDOS	ziddos.com
ZIDISHA	zidisha.org
ZIEGLER	ziegler.com
ZIFFDAVISENTERPRISE	ziffdavisenterprise.com
ZIFTIT	ziftit.com
ZIGABID	zigabid.com
ZIGAIR	zigair.com
ZIGGO	ziggo.com
ZIGLAW	ziglaw.com
ZIGLIFT	ziglift.com
ZIGNAGE	zignage.com
ZIIPPI	ziippi.com
ZIIVA	ziiva.com
ZIIVAA	ziivaa.com
ZIJI	ziji.com
ZILERGY	zilergy.com
ZILICUS	zilicus.com
ZILLABYTE	zillabyte.com
ZILLACOMM	zillacomm.net
ZILLIANT	zilliant.com
ZILLIONDESIGNS	zilliondesigns.com
ZILLIONINFO	zillioninfo.com
ZILLNER	zillner.com
ZILLOW	zillow.com
ZILOG	zilog.com
ZIMCODE	zimcode.com
ZIMMAR	zimmar.com
ZIMMER-DESIGN	zimmer-design.com
ZIMMER	zimmer.com
ZIMPERIUM	zimperium.com
ZINCH	zinch.com
ZINCVIZ	zincviz.com
ZINDIGO	zindigo.com
ZING	zing.net
ZINGENUITY	zingenuity.com
ZINGFIN	zingfin.com
ZINIO	zinio.com
ZINNCORP	zinncorp.com
ZINPRO	zinpro.com
ZINZINO	zinzino.com
ZIOSK	ziosk.com
ZIPCAR	zipcar.com
ZIPCAST	zipcast.com
ZIPEDTECH	zipedtech.com
ZIPFWORKS	zipfworks.com
ZIPGUARD	zipguard.com
ZIPLOCAL	ziplocal.com
ZIPLOGIC	ziplogic.com
ZIPMENTS	zipments.com
ZIPONGO	zipongo.com
ZIPPGO	zippgo.com
ZIPPYCART	zippycart.com
ZIPREALTY	ziprealty.com
ZIPRECRUITER	ziprecruiter.com
ZIPREPORTS	zipreports.com
ZIPSCENE	zipscene.com
ZIPSEARCH	zipsearch.com
ZIPSMART	zipsmart.com
ZIPTASK	ziptask.com
ZIPTR	ziptr.com
ZIPTRONIX	ziptronix.com
ZIPWHIP	zipwhip.com
ZIRMED	zirmed.com
ZIRNET	zirnet.com
ZIROUS	zirous.com
ZIRTUAL	zirtual.com
ZIRX	zirx.com
ZISTOS	zistos.com
ZIVELO	zivelo.com
ZIVITY	zivity.com
ZIXCORP	zixcorp.com
ZKACCESS	zkaccess.com
ZLANGO	zlango.com
ZLEMMA	zlemma.com
ZLINGO	zlingo.com
ZLRIGNITION	zlrignition.com
ZLUX	zlux.com
ZMASSOCIATES	zmassociates.com
ZMAX	zmax.com
ZMDI	zmdi.com
ZMODO	zmodo.com
ZMOLD	zmold.com
ZNETVISION	znetvision.com
ZNGINE	zngine.com
ZNZ	znz.net
ZOBER	zober.com
ZOBHA	zobha.com
ZOBRIO	zobrio.com
ZOCDOC	zocdoc.com
ZOCOPEDIA	zocopedia.com
ZODHI	zodhi.com
ZOECITY	zoecity.com
ZOEFTIG	zoeftig.com
ZOESCRIPTS	zoescripts.com
ZOETICX	zoeticx.com
ZOETIK	zoetik.com
ZOFARI	zofari.com
ZOGATEC	zogatec.com
ZOJIRUSHI	zojirushi.com
ZOLL	zoll.com
ZOLONCORP	zoloncorp.com
ZOLTEK	zoltek.com
MOMTRENDS	momtrends.com
MONABAR	monabar.com
MONABUZZ	monabuzz.com
MONAEO	monaeo.com
MONARCHCARE	monarchcare.org
MONAVIE	monavie.com
MONDANI	mondani.com
MONDAYCALL	mondaycall.com
MONDEE	mondee.com
MONDELIS	mondelis.com
MONDETTA	mondetta.com
MONDOPHONIC	mondophonic.com
MONDOR	mondor.com
MONDOTTICA	mondottica.com
MONDOTUNES	mondotunes.com
MONDRAGONLINGUA	mondragonlingua.com
MONELL	monell.org
MONENCO	monenco.net
MONETAGROUP	monetagroup.com
MONETIZEMORE	monetizemore.com
MONEUAL	moneual.com
MONEXGROUP	monexgroup.com
MONEY2	money2.net
MONEYBAR	moneybar.com
MONEYBLOCK	moneyblock.com
MONEYCORP	moneycorp.com
MONEYDESKTOP	moneydesktop.com
MONEYDIRECT	moneydirect.com
MONEYGRAM	moneygram.com
MONEYLION	moneylion.com
MONEYLOGIC	moneylogic.com
MONEYMVP	moneymvp.com
MONEYSTREAM	moneystream.com
MONEYTEAMCOACH	moneyteamcoach.com
MONEYTHINK	moneythink.org
MONGOHQ	mongohq.com
MONGOLAB	mongolab.com
MONGOTEL	mongotel.com
MONIERLIFETILE	monierlifetile.com
MONIKALAMONICA	monikalamonica.com
MONIKER	moniker.com
MONITIUM	monitium.com
MONITORLATINO	monitorlatino.com
MONKEETA	monkeeta.com
MONKEYBARS	monkeybars.net
MONKEYPLUMMEDIA	monkeyplummedia.com
MONKROCK	monkrock.com
MONOPRICE	monoprice.com
MONOSONICO	monosonico.com
MONOSTUDIOS	monostudios.com
MONOTHETIC	monothetic.com
MONOXIVENT	monoxivent.com
MONQUI	monqui.com
MONROE68	monroe68.com
MONROESTAR	monroestar.com
MONSANTO	monsanto.com
MONSCIERGE	monscierge.com
MONSTER	monster.com
MONSTERCONNECT	monsterconnect.com
MONSTERCOURSES	monstercourses.com
MONSTERMEGS	monstermegs.com
MONSTERTECHS	monstertechs.com
MONSTERVINE	monstervine.com
MONSTERWEB	monsterweb.net
MONSTERWEBZ	monsterwebz.com
MONTAD	montad.com
MONTAVO	montavo.com
MONTEFIORE	montefiore.org
MONTERRA	monterra.biz
MONTESQUIEU	montesquieu.com
MONTH9BOOKS	month9books.com
MONTKID	montkid.com
MONVEE	monvee.com
MONVERA	monvera.com
MOO	moo.com
MOOBELLA	moobella.com
MOOBILA	moobila.com
MOODAFARUKA	moodafaruka.com
MOODLESHARE	moodleshare.com
MOODWIRE	moodwire.com
MOOFWD	moofwd.com
MOOG	moog.com
MOOGI	moogi.com
MOOGILU	moogilu.com
MOOGSOFT	moogsoft.com
MOOLAGRAM	moolagram.com
MOOLAHD	moolahd.com
MOOLAHOOP	moolahoop.com
MOOMKIN	moomkin.com
MOOMOOMEDIA	moomoomedia.com
MOONBLINK	moonblink.com
WELLEZ	wellez.com
WELLFORMANCE	wellformance.com
WELLFOUNT	wellfount.com
WELLFX	wellfx.com
WELLGEN	wellgen.com
WELLIGENT	welligent.com
WELLJUVENATE	welljuvenate.com
WELLKEEPER	wellkeeper.com
WELLMARK	wellmark.com
WELLMAX	wellmax.com
WELLNECESSITY	wellnecessity.com
WELLNESSFX	wellnessfx.com
WELLNESSIQ	wellnessiq.net
WELLNESSMATS	wellnessmats.com
WELLNESSPACE	wellnesspace.com
WELLNESSPLUS	wellnessplus.com
WELLO	wello.com
WELLOGIX	wellogix.com
WELLPOINT	wellpoint.com
WELLRIGHT	wellright.com
WELLSFARGO	wellsfargo.com
WELLSHADE	wellshade.com
WELLSOURCE	wellsource.com
WELLSPAN	wellspan.org
WELLSPRING	wellspring.org
WELLSTAFF	wellstaff.com
WELLSTAR	wellstar.org
WELLTRACKONE	welltrackone.net
WELLTRAIL	welltrail.com
WELLTRONICS	welltronics.com
WELLVIEW365	wellview365.com
WELLX	wellx.com
WELLYFISH	wellyfish.com
WELLZONE	wellzone.com
WELOCALIZE	welocalize.com
WELVIE	welvie.com
WELVISTA	welvista.org
WELZOO	welzoo.com
WEM	wem.biz
WEMAKEITSAFER	wemakeitsafer.com
WEMAKEVIDEOS	wemakevideos.net
WEMEASUREIT	wemeasureit.com
WEMEDUP	wemedup.com
WEMMCO	wemmco.com
WEMOLAB	wemolab.com
WEMPE	wempe.com
WEMULTIPLY	wemultiply.com
WENCK	wenck.com
WENCOR	wencor.com
WENDIA	wendia.com
WENESCO	wenesco.com
WENNSOFT	wennsoft.com
WENOVA	wenova.com
WENSCO	wensco.com
WEOTTA	weotta.com
WEOWE	weowe.com
WEOWNTV	weowntv.org
WEPACKITALL	wepackitall.com
WEPAY	wepay.com
WEPAYONLINE	wepayonline.net
WEPOKE	wepoke.com
WEPRESENT	wepresent.com
WEQWEST	weqwest.com
WERCWERKWORKS	wercwerkworks.com
WERELDHAVE	wereldhave.com
WERENTCENTRALMASS	werentcentralmass.com
WERKMASTER	werkmaster.com
WERREMEYER	werremeyer.com
WESBANCO	wesbanco.com
WESBELL	wesbell.com
WESC	wesc.com
WESCO	wesco.com
WESCOM	wescom.org
WESCORP	wescorp.org
WESCOSF	wescosf.com
WESCRIBEIT	wescribeit.com
WESHOP	weshop.com
WESIGHT	wesight.com
WESMART	wesmart.com
WESPEC	wespec.com
WESPIRE	wespire.com
WESSDEL	wessdel.com
WESST	wesst.org
WEST	west.com
WESTAF	westaf.org
WESTAFF	westaff.com
WESTAK	westak.com
WESTAT	westat.com
WESTCABLES	westcables.com
WESTCAT	westcat.org
WESTCOASTFLAGS	westcoastflags.com
WESTCON	westcon.com
WESTCOR	westcor.com
WESTDALE	westdale.com
WESTEC	westec.net
WESTED	wested.org
WESTEGGWEB	westeggweb.com
WESTELCOM	westelcom.com
WESTELL	westell.com
WESTERBEKE	westerbeke.com
WESTERMO	westermo.com
WESTERNU	westernu.edu
WESTFIELD	westfield.com
WESTFLY	westfly.com
WESTHAB	westhab.org
WESTHOST	westhost.com
WESTIME	westime.com
WESTJET	westjet.com
WESTLIVING	westliving.net
WESTLOG	westlog.com
WESTMONT	westmont.edu
WESTMORELANDFLINT	westmorelandflint.com
WESTONGRAPHICS	westongraphics.com
WESTOWER	westower.com
WESTQUIP	westquip.com
WOOLRICH	woolrich.com
WOOPAAH	woopaah.com
WOOPSYDAISY	woopsydaisy.com
WOORY	woory.com
WOOT	woot.com
WOOTEC	wootec.com
WOOTHEMES	woothemes.com
WOOTINI	wootini.com
WORBOYSDESIGN	worboysdesign.com
WORC	worc.org
WORD-HOSTING-WEB	word-hosting-web.net
WORD2WORD	word2word.net
WORDALLY	wordally.com
WORDDIVE	worddive.com
WORDEXPRESS	wordexpress.net
WORDGIRL	wordgirl.biz
WORDINAIRE	wordinaire.com
WORDPOWERUSA	wordpowerusa.com
WORDPRO	wordpro.net
WORDRAKE	wordrake.com
WORDS2SAVOR	words2savor.com
WORDSCRIBE	wordscribe.com
WORDSFRESH	wordsfresh.com
WORDSMITHIE	wordsmithie.com
WORDSMYTH	wordsmyth.net
WORDSTALKERS	wordstalkers.com
WORDSTOCK	wordstock.com
WORDSTREAM	wordstream.com
WORDSWITHWEIGHT	wordswithweight.com
WORDTREE	wordtree.com
WORDWARRIORS777	wordwarriors777.com
WORDWRIGHTWEB	wordwrightweb.com
WORK2FUTURE	work2future.biz
WORKABILITIES	workabilities.org
WORKBEAST	workbeast.com
WORKBOOK	workbook.com
WORKBOX	workbox.com
WORKCOMPCENTRAL	workcompcentral.com
WORKCOMPONE	workcompone.com
WORKDAY	workday.com
WORKERSCHOICEUSA	workerschoiceusa.com
WORKFLOWAR	workflowar.com
WORKFLOWONE	workflowone.com
WORKFOLIO	workfolio.com
WORKFORCEGROWTH	workforcegrowth.com
WORKFORCESOURCE	workforcesource.com
WORKFORCETACTIX	workforcetactix.com
WORKFUSION	workfusion.com
WORKFUZE	workfuze.com
WORKGOAL	workgoal.com
WORKGURU	workguru.org
WORKHINT	workhint.com
WORKINGMATTERS	workingmatters.com
WORKINGMOM	workingmom.com
WORKINGPOINT	workingpoint.com
WORKKAFE	workkafe.com
WORKLAY	worklay.com
WORKLIGHT	worklight.com
WORKLOGIX	worklogix.com
WORKMAGIC	workmagic.com
WORKMATTERS	workmatters.org
WORKMETHODS	workmethods.com
WORKMYAPP	workmyapp.com
WORKNGEAR	workngear.com
WORKOLOGY	workology.com
WORKOPOLIS	workopolis.com
WORKOSOPHY	workosophy.com
WORKOUTLABS	workoutlabs.com
WORKPOP	workpop.com
WORKPROS	workpros.com
WORKREADYGRAD	workreadygrad.com
WORKRECORDS	workrecords.com
WORKREFERRAL	workreferral.com
WORKRITE	workrite.com
WORKSBUREAU	worksbureau.com
WORKSCAPE	workscape.com
WORKSCAPES	workscapes.com
WORKSKIFF	workskiff.com
WORKSMART	worksmart.com
WORKSOFT	worksoft.com
WORKSPRING	workspring.com
WORKSQUARED	worksquared.com
WORKSTEPS	worksteps.com
WORKSTERS	worksters.com
WORKSTRATEGY	workstrategy.com
WORKTERRA	workterra.com
WORKTODATE	worktodate.com
WORKTOPIA	worktopia.com
WORKURBAN	workurban.org
WORKWAY	workway.com
WORKXPRESS	workxpress.com
WORKZEIT	workzeit.com
WORKZONE	workzone.com
WORLDAPP	worldapp.com
WORLDATA	worldata.com
WORLDATWORK	worldatwork.org
WORLDAUTOSTEEL	worldautosteel.org
WORLDBANK	worldbank.org
WORLDCELL	worldcell.com
WORLDCLAIM	worldclaim.net
WORLDCOLOR	worldcolor.com
WORLDCOO	worldcoo.com
WORLDDENVER	worlddenver.org
WORLDENERGY	worldenergy.com
WORLDEYECAM	worldeyecam.com
WORLDFUND	worldfund.org
WORLDHOTELS	worldhotels.com
WORLDLY	worldly.com
WORLDLYNK	worldlynk.com
WORLDMEDIA	worldmedia.net
WORLDNOW	worldnow.com
WORLDOFCABLES	worldofcables.com
WORLDOFTRADE	worldoftrade.com
WORLDPAC	worldpac.com
WORLDPANTRY	worldpantry.com
WORLDPMO	worldpmo.com
WORLDQUANT	worldquant.com
WORLDREADER	worldreader.org
WORLDRELAY	worldrelay.net
WORLDRELO	worldrelo.com
WORLDRPO	worldrpo.com
WORLDSPAN	worldspan.com
WORLDSTRIDES	worldstrides.com
WORLDSTRIDES	worldstrides.org
WORLDTEACH	worldteach.org
WORLDTEAM	worldteam.org
WORLDTRAVELINC	worldtravelinc.com
WORLDULTRAFIT	worldultrafit.com
WORLDVENTURE	worldventure.com
WORLDVIZ	worldviz.com
WORLDWATER	worldwater.com
WORLDWIDEMARKETS	worldwidemarkets.com
WORLDWIDENATE	worldwidenate.com
WORLDWINNER	worldwinner.com
WORLDWISE	worldwise.com
WORLDWYLDWEB	worldwyldweb.com
WORLEYPARSONS	worleyparsons.com
WORLEYWORKS	worleyworks.com
WORMALD	wormald.com
WORMHOLERIDERS	wormholeriders.com
WORQPLACE	worqplace.com
WORTHPOINT	worthpoint.com
WORX4YOU	worx4you.com
WORZALLA	worzalla.com
WOUNDVISION	woundvision.com
WOVENART	wovenart.net
WOVENWARE	wovenware.com
WOWASH	wowash.com
WOWGREEN	wowgreen.net
WOWRACK	wowrack.com
WOWSTUFF	wowstuff.com
WOWT	wowt.com
WOWWEE	wowwee.com
WOWZERS	wowzers.com
WOXXER	woxxer.com
WOXY	woxy.com
WPAHS	wpahs.org
WPARTIST	wpartist.net
WPBEGINNER	wpbeginner.com
WPCI	wpci.com
WPCOG	wpcog.org
WPERFUMES	wperfumes.com
WPI	wpi.edu
WPLEX	wplex.com
WPLG	wplg.com
WPMCONSULTING	wpmconsulting.com
WPP	wpp.com
WPROMOTE	wpromote.com
WPSITE	wpsite.net
WPSTORECART	wpstorecart.com
WPTV	wptv.com
WPUNIVERSITY	wpuniversity.com
WPUNJ	wpunj.edu
WQLN	wqln.org
WQME	wqme.com
WQN	wqn.com
WRAL	wral.com
WRAMSCO	wramsco.com
WRAPJAX	wrapjax.com
WRAPP	wrapp.com
WRAPSOL	wrapsol.com
WRAR	wrar.com
WRAYWARD	wrayward.com
WRECORP	wrecorp.com
WRECYCLEIT	wrecycleit.com
WREG	wreg.com
WREK	wrek.org
WRENCHLIST	wrenchlist.com
WRENPHOTO	wrenphoto.biz
WREX	wrex.com
WRGB	wrgb.com
WRIC	wric.com
WRIGHT-PIERCE	wright-pierce.com
WRIGHTBRANDS	wrightbrands.com
WRIGHTIMC	wrightimc.com
WRIGHTSOFT	wrightsoft.com
WRIGLEY	wrigley.com
WRIKE	wrike.com
WRISTIES	wristies.com
WRISTWAND	wristwand.com
WRIT	writ.com
ZOLUZEN	zoluzen.com
ZOMATO	zomato.com
ZOMAZZ	zomazz.com
ZOMI	zomi.net
ZOMM	zomm.com
ZONDERVAN	zondervan.com
ZONE24X7	zone24x7.com
ZONEREADY	zoneready.net
ZONES	zones.com
ZONEWORKS	zoneworks.com
ZONG	zong.com
ZONIEX	zoniex.com
ZONOFF	zonoff.com
ZONOSANITECH	zonosanitech.com
ZOOBLE	zooble.com
ZOODLES	zoodles.com
ZOOFFER	zooffer.com
ZOOGRAB	zoograb.com
ZOOGUE	zoogue.com
ZOOKAWARE	zookaware.com
ZOOLIAD	zooliad.com
ZOOM	zoom.com
ZOOMCARE	zoomcare.com
ZOOMCATALOG	zoomcatalog.com
ZOOMDATA	zoomdata.com
ZOOMDOUT	zoomdout.com
ZOOMEDIA	zoomedia.com
ZOOMINFO	zoominfo.com
ZOOMINGO	zoomingo.com
ZOOMINTERVIEWS	zoominterviews.com
ZOOMONTANA	zoomontana.org
ZOOMREPORTS	zoomreports.com
ZOOMRX	zoomrx.com
ZOOMTILT	zoomtilt.com
ZOOMUS	zoomus.com
ZOONATION	zoonation.com
ZOOPPA	zooppa.com
ZOOSEO	zooseo.com
ZOOSHOO	zooshoo.com
ZOOVE	zoove.com
ZORAN	zoran.com
ZORBASOFT	zorbasoft.com
ZORCH	zorch.com
ZORGANIZE	zorganize.net
ZORKMAGAZINE	zorkmagazine.com
ZORPIA	zorpia.com
ZOVIX	zovix.com
ZOWWI	zowwi.com
ZOYTO	zoyto.com
ZOZI	zozi.com
ZPAPER	zpaper.com
ZPIZZA	zpizza.com
ZPREPAY	zprepay.com
ZQGAME	zqgame.com
ZRII	zrii.com
ZRINITY	zrinity.com
ZRODFX	zrodfx.com
ZTHERNET	zthernet.com
ZTRADEFX	ztradefx.com
ZTRONICS	ztronics.com
ZTSYSTEMS	ztsystems.com
ZU	zu.com
ZUBAWING	zubawing.com
ZUFOG	zufog.com
ZUKLU	zuklu.com
ZULAHOO	zulahoo.com
ZULAMA	zulama.com
ZULIEVELAW	zulievelaw.com
ZULUTRADE	zulutrade.com
ZUMAOOH	zumaooh.com
ZUMASYS	zumasys.com
ZUMETRICS	zumetrics.com
ZUMEX	zumex.com
ZUMIC	zumic.com
ZUMIEZ	zumiez.com
ZUMIX	zumix.org
ZUMOBI	zumobi.com
ZUMPER	zumper.com
ZUNATI	zunati.com
ZUNESIS	zunesis.com
ZUNTIK	zuntik.com
ZUORA	zuora.com
ZUPEREVENTZ	zupereventz.com
ZUPREEM	zupreem.com
ZURCO	zurco.com
ZURICH	zurich.com
ZURICKDAVIS	zurickdavis.com
ZURPLE	zurple.com
ZURVAHN	zurvahn.com
ZUWERKS	zuwerks.com
ZUYDER	zuyder.com
ZUZATZ	zuzatz.com
ZWIFT	zwift.com
ZWIKK	zwikk.com
ZWILLGEN	zwillgen.com
ZWIPE	zwipe.com
ZWOOR	zwoor.com
ZX900	zx900.com
ZXCAPITAL	zxcapital.com
ZYB	zyb.com
ZYCKO	zycko.com
ZYCON	zycon.com
ZYCUS	zycus.com
ZYDOC	zydoc.com
ZYEEDA	zyeeda.com
ZYGO	zygo.com
ZYGODIGITAL	zygodigital.com
ZYLAB	zylab.com
ZYLIGHT	zylight.com
ZYLOMED	zylomed.com
ZYLUN	zylun.com
ZYMERA	zymera.com
ZYNERGY	zynergy.com
ZYNGA	zynga.com
ZYNGENIA	zyngenia.com
ZYNNYME	zynnyme.com
ZYNTONY	zyntony.com
ZYPCOM	zypcom.com
ZYQUEST	zyquest.com
ZYRKA	zyrka.com
ZYRRA	zyrra.com
ZYWAVE	zywave.com
ZYXEL	zyxel.com
WRITEBOSTON	writeboston.org
WRITEDESTINY	writedestiny.com
WRITERACCESS	writeraccess.com
WRITERMOM	writermom.net
WRITETOLOSE	writetolose.com
WRITTALIN	writtalin.com
WRITTEN	written.com
WRITUM	writum.com
WRKIMAGES	wrkimages.com
WRKK	wrkk.com
WRMC	wrmc.com
WRNI	wrni.org
WRNR	wrnr.com
WRPBITV	wrpbitv.com
WRSCOMPASS	wrscompass.com
WRTI	wrti.org
WRUGRADIO	wrugradio.com
WRVO	wrvo.org
WSAA	wsaa.com
WSAW	wsaw.com
WSAZ	wsaz.com
WSBPA	wsbpa.org
WSBT	wsbt.com
WSCFF	wscff.org
WSECU	wsecu.org
WSFA	wsfa.com
WSFSSH	wsfssh.org
WSG	wsg.net
WSGR	wsgr.com
WSI	wsi.com
WSIFB	wsifb.com
WSIMARKETING4THEWEB	wsimarketing4theweb.com
WSIPC	wsipc.org
WSIROI	wsiroi.com
WSISD	wsisd.net
WSJ	wsj.com
WSKG	wskg.org
WSLS	wsls.com
WSMV	wsmv.com
WSNA	wsna.org
WSOL	wsol.com
WSPA	wspa.org
WSPD	wspd.com
WSPT	wspt.org
WSRE	wsre.org
WSRP	wsrp.com
WSSRA	wssra.org
WSSU	wssu.edu
WSU	wsu.edu
WSUP	wsup.org
WSVN	wsvn.com
WTAP	wtap.com
WTAS	wtas.com
WTBI	wtbi.com
WTCMHMR	wtcmhmr.org
WTDC	wtdc.com
WTEC	wtec.org
WTEF	wtef.org
WTFS	wtfs.org
WTHR	wthr.com
WTI	wti.com
WTLC	wtlc.org
WTMS	wtms.com
WTO	wto.org
WTOK	wtok.com
WTOL	wtol.com
WTS	wts.com
WTTW	wttw.com
WTVA	wtva.com
WTVISION	wtvision.com
WTVP	wtvp.org
WTVQ	wtvq.com
WTWO	wtwo.com
WUBB	wubb.com
WUGNET	wugnet.com
WUNDERLEY	wunderley.com
WUNDERLOOP	wunderloop.com
WUNDERMAN	wunderman.com
WUNDERMARX	wundermarx.com
WUNDUR	wundur.com
WURCON	wurcon.com
WURDSURF	wurdsurf.com
WURKINSTIFFS	wurkinstiffs.com
WURLPOOL	wurlpool.com
WURTEC	wurtec.com
WURZBURG	wurzburg.com
WUTZNXT	wutznxt.com
WUTZWHAT	wutzwhat.com
WVCW	wvcw.org
WVDHHR	wvdhhr.org
WVIA	wvia.org
WVLS	wvls.org
WVLT-TV	wvlt-tv.com
WVMHCA	wvmhca.org
WVMI	wvmi.org
WVSAO	wvsao.gov
WVU	wvu.edu
WVWD	wvwd.org
WWE	wwe.com
WWFC	wwfc.biz
WWL-TV	wwl-tv.com
WWNS	wwns.com
WWOCAR	wwocar.com
WWPC	wwpc.com
WWPD	wwpd.net
WWT	wwt.com
WWU	wwu.edu
WWXPLORATION	wwxploration.com
WXANALYST	wxanalyst.com
WXEL	wxel.org
WXOW	wxow.com
WYATTDESIGNGROUP	wyattdesigngroup.com
WYCD	wycd.com
WYCHE	wyche.com
WYES	wyes.org
WYETH	wyeth.com
WYFFELS	wyffels.com
WYLDEMONETTI	wyldemonetti.com
WYLE	wyle.com
WYLEI	wylei.com
WYNBI	wynbi.com
WYNDSTORM	wyndstorm.com
WYNEDGE	wynedge.com
WYNGSPAN	wyngspan.com
WYNIT	wynit.com
WYNNCOM	wynncom.com
WYNNESTONE	wynnestone.com
WYNNEWORKS	wynneworks.com
WYOTECH	wyotech.edu
WYPR	wypr.org
WYRDTEK	wyrdtek.com
WYSHME	wyshme.com
WYSIWASH	wysiwash.com
WYSIWYG	wysiwyg.net
WYSONG	wysong.net
WYZFAM	wyzfam.com
X-ANALOG	x-analog.com
X1	x1.com
X13	x13.com
X2IMPACT	x2impact.com
X3CREATIVE	x3creative.com
X3EAST	x3east.com
XAAR	xaar.com
XACTWARE	xactware.com
XAGROX	xagrox.com
XAL	xal.com
XALLES	xalles.com
XAMARIN	xamarin.com
XAMONLINE	xamonline.com
XAMOUNT	xamount.com
XAMPLIFIER	xamplifier.com
XANASURE	xanasure.com
XAND	xand.com
XANDREPRESS	xandrepress.com
XANGATI	xangati.com
XANGO	xango.com
XANGO	xango.net
XANITOS	xanitos.com
XANOFI	xanofi.com
XANSA	xansa.com
XANTE	xante.com
XANTERRA	xanterra.com
XANTRION	xantrion.com
XAPPMEDIA	xappmedia.com
XARIOS	xarios.com
XASYSTEMS	xasystems.com
XAVIANT	xaviant.com
XAWARE	xaware.com
XAXII	xaxii.com
XBITECH	xbitech.com
XBIZ	xbiz.com
XBOXFOCUS	xboxfocus.com
XCCELERATEHR	xcceleratehr.com
XCEDEX	xcedex.com
XCEEDID	xceedid.com
XCEEDIUM	xceedium.com
WESTREP	westrep.com
WESTRIVE	westrive.org
WESTROGERS	westrogers.com
WESTROPE	westrope.com
WESTSHIREBMC	westshirebmc.com
WESTUM	westum.com
WESTUSA	westusa.com
WESTVEN	westven.com
WESTWOODONE	westwoodone.com
WESTWORDVISION	westwordvision.com
WETA	weta.com
WETDOG	wetdog.net
WETEXTSA	wetextsa.com
WETHEGAMERZ	wethegamerz.com
WETHERHOLT	wetherholt.com
WETREATFEET	wetreatfeet.com
WETUBERS	wetubers.com
WEVIDEO	wevideo.com
WEVIO	wevio.com
WEVIVA	weviva.org
WEXZONE	wexzone.com
WEYERHAEUSER	weyerhaeuser.com
WFAA	wfaa.com
WFAE	wfae.org
WFD	wfd.com
WFDE	wfde.com
WFIS	wfis.org
WFMH	wfmh.com
WFMJ	wfmj.com
WFMU	wfmu.org
WFMZ	wfmz.com
WFOFR	wfofr.com
WFP	wfp.org
WFPSB	wfpsb.org
WFRB	wfrb.com
WFRN	wfrn.com
WFSB	wfsb.com
WFTDA	wftda.com
WFTV	wftv.com
WFUBMC	wfubmc.edu
WFUV	wfuv.org
WFYI	wfyi.org
WGBH	wgbh.org
WGBY	wgby.org
WGES	wges.com
WGGB	wggb.com
WGGC	wggc.com
WGTECH	wgtech.com
WHADDUPNOW	whaddupnow.com
WHALEACOUSTICS	whaleacoustics.com
WHAMMOBILE	whammobile.com
WHAT2DESIGN	what2design.com
WHATARMY	whatarmy.com
WHATCOUNTS	whatcounts.com
WHATPULSE	whatpulse.org
WHATRUNSWHERE	whatrunswhere.com
WHATSAPP	whatsapp.com
WHATSBUSY	whatsbusy.com
WHATTHEWIRELESS	whatthewireless.com
WHCC	whcc.com
WHC	whco.nl
WHEATFIELDS	wheatfields.com
WHEDA	wheda.com
WHEELCO	wheelco.com
WHEELREVOLUTION	wheelrevolution.net
WHEELS	wheels.com
WHEELS4HOPE	wheels4hope.org
WHEELSBOUTIQUE	wheelsboutique.com
WHEELWORKS	wheelworks.com
WHERE2GETIT	where2getit.com
WHEREOWARE	whereoware.com
WHERESCAPE	wherescape.com
WHETHERLY	whetherly.com
WHI	whi.com
WHIE	whie.org
WHILETRUEFORK	whiletruefork.com
WHILIKE	whilike.com
WHIMSEES	whimsees.com
WHIPCERT	whipcert.com
WHIPPERING	whippering.com
WHIPSAW	whipsaw.com
WHIPTAIL	whiptail.com
WHIREP	whirep.com
WHIRLDESIGN	whirldesign.com
WHIRLYBALL	whirlyball.com
WHISKYTREE	whiskytree.com
WHISPERCOM	whispercom.com
WHISPERTRACK	whispertrack.com
WHISTLE	whistle.com
WHISTLEBIZ	whistlebiz.com
WHISTLETREE	whistletree.com
WHITAKERIT	whitakerit.com
WHITECANYON	whitecanyon.com
WHITECLOUDS	whiteclouds.com
WHITEEXPOSITION	whiteexposition.com
WHITEFACTOR	whitefactor.com
WHITEFENCE	whitefence.com
WHITEHORSES	whitehorses.com
WHITEPAGES	whitepages.com
WHITEWATER	whitewater.biz
WHITEYBOARD	whiteyboard.com
WHITING	whiting.com
WHITKO	whitko.org
WHITLOCK	whitlock.com
WHITMOR	whitmor.com
WHITMOYER	whitmoyer.com
WHITNEYBANK	whitneybank.com
WHITTMANHART	whittmanhart.com
WHIZBANGPOWWOW	whizbangpowwow.com
WHIZRX	whizrx.com
WHLT	whlt.com
WHMCSEXTRAS	whmcsextras.com
WHOAPI	whoapi.com
WHODINII	whodinii.com
WHOGLUE	whoglue.com
WHOI	whoi.edu
WHOISCARRUS	whoiscarrus.com
WHOLECROWD	wholecrowd.com
WHOLEDAYBUY	wholedaybuy.com
WHOLEMINDS	wholeminds.com
WHOLESALEFUND	wholesalefund.com
WHOLESOMEONE	wholesomeone.com
WHOLESOMETHERAPY	wholesometherapy.com
WHOLYFIT	wholyfit.org
WHOOZAH	whoozah.com
WHOSAY	whosay.com
WHOTEACHES	whoteaches.com
WHOTOO	whotoo.com
WHOTRADES	whotrades.com
WHOVA	whova.com
WHOVOO	whovoo.com
WHOWENTOUT	whowentout.com
WHPACIFIC	whpacific.com
WHPD	whpd.com
WHPR	whpr.com
WHRB	whrb.org
WHRN	whrn.org
WHRO	whro.org
WHSV	whsv.com
WHTIMEATING	whtimeating.com
WHYDESIGNWORKS	whydesignworks.com
WHYGEE	whygee.com
WHYLINGUAL	whylingual.com
WHYNOTLEASEIT	whynotleaseit.com
WHYREBOOT	whyreboot.com
WHYY	whyy.org
WIAAA	wiaaa.org
WIBIDATA	wibidata.com
WIBW	wibw.com
WICAP	wicap.org
WICCUSA	wiccusa.net
WICELL	wicell.org
WICHCRAFT	wichcraft.com
WICHE	wiche.edu
WICHORUS	wichorus.com
WICKEDINNOVATIONS	wickedinnovations.com
NANOLUMENS	nanolumens.com
NANOMEASURE	nanomeasure.net
NANONATION	nanonation.net
NANOOGO	nanoogo.com
NANOPROBES	nanoprobes.com
NANOQUANTICS	nanoquantics.com
NANORETE	nanorete.com
NANOSAFEGUARD	nanosafeguard.com
NANOSIGHT	nanosight.com
NANOSPECTIVE	nanospective.com
NANOSPERSE	nanosperse.com
NANOSTIM	nanostim.com
NANOSURF	nanosurf.com
NANOSYN	nanosyn.com
NANOTECNEXUS	nanotecnexus.org
NANOTHERAPEUTICS	nanotherapeutics.com
NANOUNITY	nanounity.com
NANOVEA	nanovea.com
NANOVIOVA	nanoviova.com
NANSEN	nansen.com
NANTERO	nantero.com
NANUTEK	nanutek.com
NANYCRAFTS	nanycrafts.com
NANZ	nanz.com
NAOPLAY	naoplay.com
NAPASOL	napasol.com
NAPASTYLE	napastyle.com
NAPATECH	napatech.com
NAPAWF	napawf.org
NAPBS	napbs.com
NAPCO	napco.com
NAPCP	napcp.org
NAPDEN	napden.com
NAPERBRIDGE	naperbridge.org
NAPFE	napfe.org
NAPHSIS	naphsis.org
NAPIM	napim.org
NAPL	napl.org
NAPLIA	naplia.com
NAPMA	napma.com
NAPMFG	napmfg.com
NAPNAP	napnap.org
NAPPYTABS	nappytabs.com
NAPROTEK	naprotek.com
NAPSLO	napslo.org
NAPTAGS	naptags.com
NAPTECH	naptech.com
NAPWL	napwl.com
NARA	nara.gov
NARANYA	naranya.com
NARBHA	narbha.org
NARBHAVEE	narbhavee.com
NARCHITECTS	narchitects.com
NARCOMM	narcomm.com
NAREIT	nareit.com
NARF	narf.org
NARFE	narfe.org
NARFO	narfo.com
NARI	nari.org
NARPRO	narpro.com
NARRATIVE1	narrative1.com
NARSAD	narsad.org
NARUC	naruc.org
NARVLA	narvla.com
NAS	nas.edu
NASA	nasa.gov
NASBA	nasba.org
NASCADESIGN	nascadesign.com
NASCAR	nascar.com
NASCENTECHNOLOGY	nascentechnology.com
NASCENTRIC	nascentric.com
NASCO	nasco.com
NASCRAG	nascrag.org
NASCUS	nascus.org
NASDTEC	nasdtec.com
NASECARE	nasecare.com
NASEO	naseo.org
NASFAA	nasfaa.org
NASFAM	nasfam.org
NASHELLE	nashelle.com
NASHUA	nashua.com
NASI	nasi.com
NASI	nasi.org
NASMHPD	nasmhpd.org
NASOFT	nasoft.com
NASPAA	naspaa.org
NASSCO	nassco.com
NASSCO	nassco.org
NASSCOMM	nasscomm.com
NASSMC	nassmc.org
NASSTOYS	nasstoys.com
NASTC	nastc.com
NASTRAQ	nastraq.com
NASULGC	nasulgc.org
NASUNI	nasuni.com
NASW	nasw.org
NATA	nata.org
NATALSMART	natalsmart.com
NATE1DESIGN	nate1design.com
NATEL	natel.net
NATES	nates.net
NATGEM	natgem.com
NATI	nati.net
NATIONAIR	nationair.com
NATIONALFIELD	nationalfield.com
NATIONALHR	nationalhr.com
NATIONALVISION	nationalvision.com
NATIONALWALLCOVERING	nationalwallcovering.com
NATIONSAT	nationsat.com
NATIONSCLASSROOM	nationsclassroom.com
NATIONSREO	nationsreo.com
NATIONSUBMIT	nationsubmit.com
NATIONSWELL	nationswell.com
NATIONWIDE	nationwide.com
WANNABEESOCIAL	wannabeesocial.com
WANNABEMOBILE	wannabemobile.com
WANNABESOCIAL	wannabesocial.com
WANTADS4U	wantads4u.com
WANTFUL	wantful.com
WANTICKETS	wantickets.com
WAOAW	waoaw.com
WAOW	waow.com
WAPATOOME	wapatoome.com
WAPPOW	wappow.com
WARATAH	waratah.com
WARC	warc.com
WARECORP	warecorp.com
WAREFORCE	wareforce.com
WAREHOUSERACK	warehouserack.com
WAREINC	wareinc.com
WARESTAFF	warestaff.com
WARF	warf.org
WARISON	warison.net
WARMFLOORS4U	warmfloors4u.com
WARMFOCUS	warmfocus.com
WARMLYYOURS	warmlyyours.com
WARNACO	warnaco.com
WARPEX	warpex.com
WARPHIRE	warphire.com
WARPRADIO	warpradio.com
WARSCHAWSKI	warschawski.com
WARTBURG	wartburg.org
WARTSILA	wartsila.com
WASABE	wasabe.biz
WASB	wasb.org
WASCHE	wasche.com
WASHBURN	washburn.edu
WASHINK	washink.com
WASHMETRICS	washmetrics.com
WASHPIRG	washpirg.org
WASPMOBILE	waspmobile.com
WASSCO	wassco.com
WASSERSTROM	wasserstrom.com
WASTECORP	wastecorp.com
WASTEQUIP	wastequip.com
WASTERASERS	wasterasers.com
WASTESTRATEGIES	wastestrategies.com
WASTEZERO	wastezero.com
WATAGAME	watagame.com
WATC	watc.edu
WATCHDOX	watchdox.com
WATCHITOO	watchitoo.com
WATCHLAB	watchlab.com
WATCHMEGROW	watchmegrow.com
WATCHPLAYREAD	watchplayread.com
WATCHSEND	watchsend.com
WATCHTIME	watchtime.com
WATCHUP	watchup.com
WATE	wate.com
WATER-RIGHT	water-right.com
WATER2SAVE	water2save.com
WATER4	water4.org
WATERAID	wateraid.org
WATERBOYS	waterboys.biz
WATERBOYZ	waterboyz.com
WATERCOOKIES	watercookies.org
WATERFALL	waterfall.com
WATERFORD	waterford.org
WATERFURNACE	waterfurnace.com
WATERGRAPHICS	watergraphics.com
WATERGROUP	watergroup.com
WATERIDGE	wateridge.com
WATERJOBS	waterjobs.com
WATERLEAU	waterleau.com
WATERLEX	waterlex.org
WATERLOG	waterlog.com
WATERLOGISTICS	waterlogistics.com
WATERMISER	watermiser.com
WATERONE	waterone.org
WATERPIK	waterpik.com
WATERPLACES	waterplaces.biz
WATERPR	waterpr.com
WATERPRO	waterpro.net
WATERPROFESSIONALS	waterprofessionals.com
WATERQ	waterq.com
WATERROWER	waterrower.com
WATERS	waters.com
WATERSCAPE	waterscape.biz
WATERSIGNAL	watersignal.com
WATERSPROUT	watersprout.org
WATERSURPLUS	watersurplus.com
WATERSWORLD	watersworld.com
WATERTECTONICS	watertectonics.com
WATERTRAC	watertrac.com
WATERVLEET	watervleet.com
WATERWALLA	waterwalla.org
WATERWORKS	waterworks.com
WATERWORTHDESIGN	waterworthdesign.com
WATG	watg.com
WATHEN-CASTANOS	wathen-castanos.com
NVCC	nvcc.edu
NVDI	nvdi.com
NVENERGY	nvenergy.com
NVENTIVE	nventive.com
NVERZION	nverzion.com
NVIDIA	nvidia.com
NVISIA	nvisia.com
NVISIUM	nvisium.com
NVITE	nvite.com
NVLA	nvla.net
NVMS	nvms.com
NVP	nvp.com
NVPR	nvpr.com
NVRC	nvrc.org
NVRE	nvre.net
NVT	nvt.com
NVTRP	nvtrp.org
NW3C	nw3c.org
NWACC	nwacc.edu
NWAOG	nwaog.com
NWAY	nway.com
NWCA	nwca.com
NWCDS	nwcds.org
NWEA	nwea.org
NWEMC	nwemc.com
NWF	nwf.org
NWFA	nwfa.org
NWFACADE	nwfacade.com
NWL	nwl.com
NWMLS	nwmls.com
NWNSI	nwnsi.com
NWRA	nwra.com
NWRECC	nwrecc.org
NWRPROS	nwrpros.com
NWSAM	nwsam.com
NWSCDC	nwscdc.org
NWTC	nwtc.edu
NWTF	nwtf.net
NXEGEN	nxegen.com
NXGEN	nxgen.com
NXP	nxp.com
NXTASIA	nxtasia.com
NXTEVENT	nxtevent.com
NXTTEAM	nxtteam.com
NXTWALL	nxtwall.com
NY2O	ny2o.com
NYAHSA	nyahsa.org
NYASLA	nyasla.org
NYBDC	nybdc.com
NYBLACKCAR	nyblackcar.com
NYC-CONNECTIONS	nyc-connections.com
NYCARTSCYPHER	nycartscypher.com
NYCBD	nycbd.com
NYCBOE	nycboe.net
NYCDOE	nycdoe.net
NYCDOE	nycdoe.org
NYCEDC	nycedc.com
NYCFNAC	nycfnac.org
NYCHHC	nychhc.org
NYCLASS	nyclass.org
NYCNVC	nycnvc.org
NYCOMS	nycoms.com
NYCRS	nycrs.com
NYCRX	nycrx.org
NYCSCA	nycsca.org
NYCTIES	nycties.org
NYCVA	nycva.org
NYDVS	nydvs.com
NYENBURGH	nyenburgh.com
NYFA	nyfa.org
NYFU	nyfu.com
NYGHTFALCON	nyghtfalcon.com
NYHC	nyhc.com
NYHRC	nyhrc.com
NYINSULATE	nyinsulate.com
NYIPA	nyipa.org
NYISE	nyise.org
NYISO	nyiso.com
NYIT	nyit.edu
NYKAMPNYBOER	nykampnyboer.com
NYLACAST	nylacast.com
NYLAHD	nylahd.com
NYLATECH	nylatech.com
NYLOFT	nyloft.net
NYMC	nymc.com
NYMDESIGN	nymdesign.com
NYMEO	nymeo.org
NYMEX	nymex.com
NYMIRUM	nymirum.com
NYNE	nyne.com
NYOOZI	nyoozi.com
NYOPOLY	nyopoly.com
NYP	nyp.org
NYPACE	nypace.org
NYPCC	nypcc.org
NYPIRG	nypirg.org
NYPL	nypl.org
NYPLA	nypla.com
NYPPEX	nyppex.com
NYPRO	nypro.com
NYREI	nyrei.com
NYRICH	nyrich.com
NYRSTAR	nyrstar.com
NYSACRA	nysacra.org
NYSCA	nysca.org
NYSD	nysd.com
NYSDRA	nysdra.org
NYSE	nyse.com
NYSEG	nyseg.com
NYSERNET	nysernet.org
NYSID	nysid.org
NYSIF	nysif.com
NYSNA	nysna.org
NYSORA	nysora.com
NYSPACE	nyspace.com
NYSSCPA	nysscpa.org
NYSTROM	nystrom.com
NYTSSC	nytssc.com
YIELDMO	yieldmo.com
YIFTEE	yiftee.com
YIHAODIAN	yihaodian.com
YINCAE	yincae.com
YINZGOT	yinzgot.com
YIP	yip.com
YIPES	yipes.com
YIPPA	yippa.com
YIPPY	yippy.com
YISD	yisd.net
YISRAELINK	yisraelink.org
YITCO	yitco.com
YKHC	ykhc.org
YKLI	ykli.org
YLDA	ylda.org
YMARKETING	ymarketing.com
YMCA	ymca.net
YMCA	ymca.org
YNHH	ynhh.org
YNRINSIDER	ynrinsider.com
YO2MO	yo2mo.com
YOAKLEYPR	yoakleypr.com
YODELIST	yodelist.com
YODELPOP	yodelpop.com
YODERM	yoderm.com
YODIL	yodil.com
YODIO	yodio.com
YODLE	yodle.com
YODLEE	yodlee.com
YOFORIA	yoforia.com
YOGABABE	yogababe.net
YOGACAPS	yogacaps.org
YOGADIANA	yogadiana.com
YOGADVENTURES	yogadventures.com
YOGAFIT	yogafit.com
YOGAGLO	yogaglo.com
YOGAHII	yogahii.com
YOGAHITCH	yogahitch.com
YOGAHOME	yogahome.com
YOGAKULA	yogakula.com
YOGAMEDICS	yogamedics.net
YOGAPEUTICS	yogapeutics.com
YOGAPRO	yogapro.com
YOGARAT	yogarat.com
YOGASHEILA	yogasheila.com
YOGASPIRA	yogaspira.com
YOGAVIBES	yogavibes.com
YOGAVILLE	yogaville.org
YOGAVIVE	yogavive.com
YOGIIZA	yogiiza.com
YOGO	yogo.net
YOH	yoh.com
YOKABOO	yokaboo.com
YOLI	yoli.com
YOLOCARE	yolocare.com
YOLODEALS	yolodeals.com
YOMI	yomi.com
YONDUR	yondur.com
YONIX	yonix.com
YONOVEOTELE	yonoveotele.com
YONYX	yonyx.com
YOOBI	yoobi.com
YOOZY	yoozy.com
YORANGO	yorango.com
YORKARTS	yorkarts.org
YORKSIGNS	yorksigns.com
YORKTEL	yorktel.com
YOTEL	yotel.com
YOTTAA	yottaa.com
YOTTAMARK	yottamark.com
YOTTAVOTE	yottavote.com
YOUBETME	youbetme.com
YOUBLOOM	youbloom.com
YOUCAKE	youcake.com
YOUCALLMD	youcallmd.com
YOUDOPR	youdopr.com
YOUEARNEDIT	youearnedit.com
YOUEYE	youeye.com
YOUFIT	youfit.com
YOUFOLIO	youfolio.com
YOUGIVEGOODS	yougivegoods.com
YOUGOV	yougov.com
YOULAYAWAY	youlayaway.com
YOUMETHINK	youmethink.com
YOUMEWEUS	youmeweus.com
YOUNGERTECH	youngertech.com
YOUNGEVITY	youngevity.com
YOUNGJETS	youngjets.com
YOUNGMINDZ	youngmindz.biz
YOUNIVERSITYTV	youniversitytv.com
YOUNOODLE	younoodle.com
YOUNOW	younow.com
YOUPLUSMEDIA	youplusmedia.com
YOUPORN	youporn.com
YOURBOW	yourbow.com
YOURBUSINESSCHANNEL	yourbusinesschannel.com
YOURCASH	yourcash.com
YOURDESIGN2	yourdesign2.com
YOURDICTIONARY	yourdictionary.com
YOURENCORE	yourencore.com
YOURESPACE	yourespace.com
YOURGURU	yourguru.com
YOURHOLIDAYS	yourholidays.com
YOURISHMENT	yourishment.com
YOURITGROUP	youritgroup.net
YOURKIDVID	yourkidvid.com
YOURMECHANIC	yourmechanic.com
YOURPARTYHUB	yourpartyhub.com
YOURQUEST	yourquest.com
YOURRDONLINE	yourrdonline.com
WATLOW	watlow.com
WATSCO	watsco.com
WATSI	watsi.org
WATSONDIGITAL	watsondigital.com
WATTCO	wattco.net
WATTEREDGE	watteredge.com
WATTMINDER	wattminder.com
WATTNEXT	wattnext.net
WATTPAD	wattpad.com
WATTTIME	watttime.org
WAUWAA	wauwaa.com
WAVE6	wave6.com
WAVEBID	wavebid.com
WAVEBORN	waveborn.com
WAVEBOURN	wavebourn.com
WAVECLOUD	wavecloud.com
WAVECOMM	wavecomm.com
WAVEGROUP	wavegroup.com
WAVELINK	wavelink.com
WAVEONE	waveone.com
WAVEOP	waveop.com
WAVEPILOT	wavepilot.com
WAVES4POWER	waves4power.com
WAVESPOT	wavespot.net
WAVESTAFF	wavestaff.com
WAVESTOREUSA	wavestoreusa.com
WAVESTREAM	wavestream.com
WAVETABLE	wavetable.com
WAVETRONIX	wavetronix.com
WAVICLE	wavicle.com
WAVII	wavii.com
WAVIN	wavin.com
WAVLITE	wavlite.com
WAVSYS	wavsys.com
WAWA	wawa.com
WAWPUF	wawpuf.com
WAXBITCH	waxbitch.com
WAXIE	waxie.com
WAXXDEIGHT	waxxdeight.com
WAY2SPIRIT	way2spirit.com
WAYCROSSE	waycrosse.com
WAYFERRY	wayferry.com
WAYFINDER	wayfinder.com
WAYFOUNDER	wayfounder.com
WAYIN	wayin.com
WAYNECONCEPTS	wayneconcepts.com
WAYNSYS	waynsys.com
WAYPORT	wayport.net
WAYSCOUT	wayscout.com
WAYTEK	waytek.com
WAYWORKS	wayworks.net
WAZALA	wazala.com
WAZE	waze.com
WAZWARPT	wazwarpt.com
WAZZYSPACE	wazzyspace.com
WBCCI	wbcci.org
WBCM	wbcm.com
WBCSD	wbcsd.org
WBD3	wbd3.com
WBENC	wbenc.org
WBER	wber.org
WBHM	wbhm.org
WBKO	wbko.com
WBLS	wbls.com
WBOND	wbond.net
WBOY	wboy.com
WBPARTS	wbparts.com
WBPH	wbph.org
WBSCONSULT	wbsconsult.com
WBSI	wbsi.com
WBTV	wbtv.com
WCAI	wcai.com
WCAREI	wcarei.com
WCASD	wcasd.net
WCAX	wcax.com
WCBD	wcbd.com
WCCAC	wccac.org
WCCF	wccf.org
WCCHD	wcchd.org
WCDISTRIBUTORS	wcdistributors.com
WCEC	wcec.com
WCIL	wcil.org
WCITIES	wcities.com
WCJB	wcjb.com
WCLT	wclt.com
WCOIL	wcoil.com
WCPO	wcpo.com
WCPSOLUTIONS	wcpsolutions.com
WCPSS	wcpss.net
WCQP	wcqp.com
WCQR	wcqr.org
WCRSA	wcrsa.org
WCS	wcs.org
WCSI	wcsi.com
WCSR	wcsr.com
WCSU	wcsu.edu
WCT	wct.com
WCTE	wcte.org
WCUSD	wcusd.org
WCUW	wcuw.org
WCYB	wcyb.com
WDHN	wdhn.com
WDITT	wditt.com
WDIY	wdiy.org
WDMA	wdma.com
WDSCOTT	wdscott.com
WDTV	wdtv.com
WDVX	wdvx.com
WDW	wdwn.nl
WDWTRAVELS	wdwtravels.com
WE-ENERGIES	we-energies.com
WE3KINGS	we3kings.com
WE3NET	we3net.com
WEAC	weac.org
WEALTHBROOK	wealthbrook.com
WEALTHCMT	wealthcmt.com
WEALTHCOLONY	wealthcolony.com
WEALTHENGINE	wealthengine.com
WEALTHFORGE	wealthforge.com
WEALTHGURUS	wealthgurus.com
WEALTHICITY	wealthicity.com
WEALTHKEEPERS	wealthkeepers.net
WEALTHMD	wealthmd.com
WEALTHMODES	wealthmodes.com
WEALTHONOMICS	wealthonomics.org
WEALTHPLAN	wealthplan.com
WEALTHSERV	wealthserv.com
WEALTHSITE	wealthsite.com
WEALTHSTONE	wealthstone.net
WEAPPLYFORYOU	weapplyforyou.com
WEAR2WHERE	wear2where.com
WEAREPHOTOGRAPHERS	wearephotographers.com
WEARETAYLOR	wearetaylor.com
WEARETEACHERS	weareteachers.com
WEARLIT	wearlit.com
WEARSOX	wearsox.com
WEARWELL	wearwell.com
WEARWORKS	wearworks.net
WEATHERCHEM	weatherchem.com
WEATHERCURRENTS	weathercurrents.com
WEATHERFLOW	weatherflow.com
WEATHERFORD	weatherford.com
WEATHERMATIC	weathermatic.com
WEATHERSPHERE	weathersphere.com
WEATHERVISION	weathervision.com
WEAUGMENT	weaugment.com
WEAVERWERX	weaverwerx.com
WEAVEXX	weavexx.com
WEAVVER	weavver.com
WEB-PACE	web-pace.com
WEB4HALF	web4half.com
WEB864	web864.com
WEBAIR	webair.com
WEBALO	webalo.com
WEBALOO	webaloo.com
WEBANALYTIX	webanalytix.com
WEBASSIGN	webassign.com
WEBASSIST	webassist.com
WEBATONIC	webatonic.com
WEBAUTHORINGS	webauthorings.com
WEBBANK	webbank.com
WEBBEAMS	webbeams.com
WEBBMASON	webbmason.com
WEBBONES	webbones.com
WEBBROI	webbroi.com
WEBBULA	webbula.com
WEBCAREFREE	webcarefree.com
WEBCBG	webcbg.com
WEBCE	webce.com
WEBCEASE	webcease.com
WEBCERTAIN	webcertain.com
WEBCOHESIVE	webcohesive.com
WEBCOIL	webcoil.com
WEBCOLLAGE	webcollage.com
WEBCONGRESS	webcongress.com
WEBCONJURE	webconjure.com
WEBCONSULS	webconsuls.com
WEBCOTICS	webcotics.com
WEBCULTURE	webculture.net
WEBDAM	webdam.com
WEBDEBSITES	webdebsites.com
WEBDECODER	webdecoder.com
WEBDESIGNEXPERTS	webdesignexperts.org
WEBDEVELOP	webdevelop.pro
WEBDEVRS	webdevrs.com
WEBDEZIGNERZ	webdezignerz.com
WEBDIVISION	webdivision.net
WEBDUNIA	webdunia.net
WEBEMARKETING	webemarketing.com
WEBENERTIA	webenertia.com
WEBERISH	weberish.com
WEBERMESSICK	webermessick.com
WEBESTEAM	webesteam.com
WEBEX	webex.com
WEBEXMEDIA	webexmedia.net
WEBFACTORY-ONLINE	webfactory-online.com
WEBFEAT	webfeat.com
WEBFICIENT	webficient.com
WEBFLOW	webflow.com
WEBFORGE	webforge.com
WEBGEEKHQ	webgeekhq.net
WEBGILITY	webgility.com
WEBGISTIX	webgistix.com
WEBGRAIN	webgrain.net
WEBGRAVITY	webgravity.com
WEBGUILD	webguild.com
WEBHELP	webhelp.com
WEBHEROES	webheroes.com
WEBHUE	webhue.com
WEBIDEOZ	webideoz.com
WEBIFORUM	webiforum.com
WEBIFUSION	webifusion.com
WEBII	webii.net
WEBIMAX	webimax.com
WEBINFUSED	webinfused.com
YOURTEACHER	yourteacher.com
YOURVIRTUALCONCIERGE	yourvirtualconcierge.biz
YOUSEEU	youseeu.com
YOUSENDIT	yousendit.com
YOUSHALLTHRIVE	youshallthrive.com
YOUTELLME	youtellme.com
YOUTERN	youtern.com
YOUTH-RX	youth-rx.com
YOUTH4YOUTH	youth4youth.org
YOUTHAPEDIA	youthapedia.com
YOUTHASSETS	youthassets.org
YOUTHBUILD	youthbuild.org
YOUTHFRIENDS	youthfriends.org
YOUTHFRONT	youthfront.com
YOUTHFULCITIES	youthfulcities.com
YOUTHINITY	youthinity.com
YOUTHLINC	youthlinc.org
YOUTHMARK	youthmark.com
YOUTHMERCH	youthmerch.com
YOUTHNET	youthnet.org
YOUTHPRISE	youthprise.org
YOUTHRIVE	youthrive.net
YOUTHROOTS	youthroots.org
YOUTHTRADE	youthtrade.com
YOUTHVILLE	youthville.org
YOUTHWORKS	youthworks.com
YOUTHZONE	youthzone.com
YOUTUBEMANAGER	youtubemanager.net
YOUVISIT	youvisit.com
YOUZEEK	youzeek.com
YOVIA	yovia.com
YOVILLEONLINE	yovilleonline.com
YOYOCHIMP	yoyochimp.com
YOYOFACTORY	yoyofactory.com
YOYOMETRICS	yoyometrics.com
YOYOUSOFT	yoyousoft.com
YOZELL	yozell.com
YPAL	ypal.org
YPARTNERSHIP	ypartnership.com
YPM	ypm.com
YPPHOTO	ypphoto.com
YPULSE	ypulse.com
YRCI	yrci.com
YRCW	yrcw.com
YRT2	yrt2.net
YSC	ysc.com
YSDESIGNING	ysdesigning.com
YSEOP	yseop.com
YSI	ysi.com
YSPANIOLA	yspaniola.org
YSU	ysu.edu
YSUPLOAD	ysupload.com
YSWAYFLOORING	yswayflooring.com
YTB	ytb.com
YTH	yth.org
YTVP	ytvp.com
YUBICO	yubico.com
YUCAROO	yucaroo.com
YUCKOS	yuckos.com
YUENGLING	yuengling.com
YUGMA	yugma.com
YUGO	yugo.org
YUM	yum.com
YUMAPOS	yumapos.com
YUMASUN	yumasun.com
YUME	yume.com
YUMILICIOUS	yumilicious.com
YUMMICLIX	yummiclix.com
YUMMLY	yummly.com
YUMYFIT	yumyfit.com
YUNOTECH	yunotech.com
YUNSA	yunsa.com
YUPPIEGEEKS	yuppiegeeks.com
YURBUDS	yurbuds.com
YURCOR	yurcor.com
YURU	yuru.com
YUSHI	yushi.com
YUTLE	yutle.com
YUUCONNECT	yuuconnect.com
YUUMA	yuuma.com
YUUMII	yuumii.com
YUUPAY	yuupay.com
YVFWC	yvfwc.org
YVRS	yvrs.com
YWCA	ywca.org
YWCABOSTON	ywcaboston.org
YXLON	yxlon.com
YYES	yyes.org
Z-MEDICA	z-medica.com
Z2	z2.com
Z3MEDIA	z3media.com
Z6CREATION	z6creation.net
ZAAPTVLIVE	zaaptvlive.com
ZAAVY	zaavy.com
ZAAZOOM	zaazoom.com
ZABAMBA	zabamba.com
ZACHARYGALLERY	zacharygallery.com
ZACKRA	zackra.com
ZACUTO	zacuto.com
ZADCO	zadco.com
ZADY	zady.com
ZAETRIC	zaetric.com
ZAFFERA	zaffera.com
ZAFIN	zafin.com
ZAGG	zagg.com
ZAGGORA	zaggora.com
ZAGSTER	zagster.com
ZAGWEAR	zagwear.com
ZAHAROFF	zaharoff.com
ZAIDAD4NRI	zaidad4nri.com
ZAIRGE	zairge.com
ZALEMARK	zalemark.com
ZALES	zalesi.cz
ZALLC	zallc.org
ZALP	zalp.com
ZAM	zam.com
ZAMBOO	zamboo.com
ZAMPIT	zampit.com
ZAMPLE	zample.com
ZAMTIER	zamtier.com
ZAMUELBALLET	zamuelballet.com
ZAMZEE	zamzee.com
ZANAAFRICA	zanaafrica.org
ZANBATO	zanbato.com
ZANDERGOLF	zandergolf.com
ZANDRAK	zandrak.com
ZANELLA	zanella.com
ZANENETCONNECT	zanenetconnect.com
ZANER	zaner.com
ZANETT	zanett.com
ZANKLITES	zanklites.com
ZANOBO	zanobo.com
ZANOX	zanox.com
ZANSORS	zansors.com
ZANTHUS	zanthus.com
ZANTIGO	zantigo.com
ZAP2USA	zap2usa.com
ZAPATITOS	zapatitos.org
ZAPCAST	zapcast.com
ZAPGARDEN	zapgarden.com
ZAPP360	zapp360.com
ZAPPBUG	zappbug.com
ZAPPMOBI	zappmobi.com
ZAPPOS	zappos.com
ZAPPROVED	zapproved.com
ZAPPRX	zapprx.com
ZAPTEL	zaptel.com
ZAPURA	zapura.com
ZARCOR	zarcor.com
ZAREASON	zareason.com
ZAREQ	zareq.com
ZARPAC	zarpac.com
ZARTICA	zartica.com
ZASZOU	zaszou.com
ZATTARO	zattaro.com
ZAUDHAUS	zaudhaus.com
ZAVERS	zavers.com
ZAWYA	zawya.com
ZAXCOM	zaxcom.com
ZAYKO	zayko.com
ZAYO	zayo.com
ZAZMA	zazma.com
ZAZOU	zazou.com
ZAZZLE	zazzle.com
ZBESTDESIGN	zbestdesign.com
ZBLUESOFTWARE	zbluesoftware.com
ZBODYSCULPT	zbodysculpt.com
ZBRELLA	zbrella.com
ZBUYER	zbuyer.com
ZCATER	zcater.com
ZCORUM	zcorum.com
ZDCA	zdca.com
ZDEPLOY	zdeploy.com
ZDFILMS	zdfilms.com
ZDGMEDIA	zdgmedia.com
ZDIRECT	zdirect.com
ZDISTRO	zdistro.com
ZEACHEM	zeachem.com
ZEACOM	zeacom.com
ZEALCON	zealcon.com
ZEALMARK	zealmark.com
ZEALNOUS	zealnous.com
ZEARN	zearn.org
ZEBCO	zebco.com
ZEBEK	zebek.com
ZEBIGO	zebigo.com
ZEBRA	zebra.com
ZEBRA3MEDIA	zebra3media.com
ZEBRAGRAPHICS	zebragraphics.com
ZEBRAHEALTH	zebrahealth.com
ZEBRAPLACE	zebraplace.com
ZEBRAREACH	zebrareach.com
ZECONTECH	zecontech.com
ZED451	zed451.com
ZEDASOFT	zedasoft.com
ZEDGE	zedge.net
ZEDO	zedo.com
ZEEBLU	zeeblu.com
ZEECO	zeeco.com
ZEENOTV	zeenotv.com
ZEEPRO	zeepro.com
ZEESHSOFT	zeeshsoft.com
ZEESMAN	zeesman.com
ZEEWISE	zeewise.com
ZEGLA	zegla.com
ZEHLAZEH	zehlazeh.org
ZEHNERGROUP	zehnergroup.com
ZEHNO	zehno.com
ZEINCREATIONS	zeincreations.com
ZELEDYNE	zeledyne.com
ZELLE	zelle.com
ZELLERMAN	zellerman.com
ZELNICKMEDIA	zelnickmedia.com
ZELOCITY	zelocity.com
ZELOSPORT	zelosport.com
ZELUCK	zeluck.com
ZEMEX	zemex.com
ZEMMING	zemming.com
ZEN4K9S	zen4k9s.com
ZENACOMP	zenacomp.com
ZENAGEN	zenagen.com
ZENBIO	zenbio.com
ZENBIOTIC	zenbiotic.com
ZENCODER	zencoder.com
ZENDEAVORS	zendeavors.com
ZENDESK	zendesk.com
ZENETEX	zenetex.com
ZENETTI	zenetti.com
ZENEXUS	zenexus.com
ZENFILM	zenfilm.net
ZENGENIUS	zengenius.com
ZENIG	zenig.com
ZENIT	zenit.org
ZENLY	zenly.com
ZENMARK	zenmark.com
ZENORADIO	zenoradio.com
ZENOSS	zenoss.com
ZENOSYS	zenosys.com
ZENPAYROLL	zenpayroll.com
ZENPRINT	zenprint.com
ZENPRISE	zenprise.com
ZENPUT	zenput.com
ZENSAH	zensah.com
ZENSHA	zensha.com
ZENSOURCE	zensource.net
ZENSPAOC	zenspaoc.com
ZENTA	zenta.com
ZENTANGLE	zentangle.com
ZENTECH	zentech.org
ZENTRICK	zentrick.com
ZENTS	zents.com
ZENUITY	zenuity.com
ZENXD	zenxd.com
ZENZI	zenzi.com
ZEOMEGA	zeomega.com
ZEON	zeon.com
ZEPEL	zepel.com
ZEPHZ	zephz.com
ZEPTOMETRIX	zeptometrix.com
ZERGNET	zergnet.com
ZERISTA	zerista.com
ZERIVA	zeriva.com
ZERO-MAX	zero-max.com
ZEROCATER	zerocater.com
ZEROCHAOS	zerochaos.com
ZERODIVIDE	zerodivide.org
ZEROFRACTAL	zerofractal.com
ZEROUI	zeroui.com
ZEROUV	zerouv.com
ZEROWAIT	zerowait.com
ZERVE	zerve.com
ZERYS	zerys.com
ZESECRET	zesecret.com
ZESTADZ	zestadz.com
ZESTFINANCE	zestfinance.com
ZESTOSERVE	zestoserve.com
ZESTRON	zestron.com
ZETEC	zetec.com
ZETETIC	zetetic.net
ZETHCON	zethcon.com
ZETON	zeton.com
ZETRON	zetron.com
ZETTACORE	zettacore.com
ZETTAMOBILE	zettamobile.com
ZETTICS	zettics.com
ZEUMO	zeumo.com
WEBINTENSIVE	webintensive.com
WEBISTIX	webistix.com
WEBITECTS	webitects.com
WEBITMD	webitmd.com
WEBITUP	webitup.com
WEBJAMADS	webjamads.com
WEBJOGGER	webjogger.net
WEBJUICE	webjuice.com
WEBJURIS	webjuris.com
WEBJUTSU	webjutsu.com
WEBKRATE	webkrate.com
WEBLANCE	weblance.com
WEBLAYERS	weblayers.com
WEBLEARNING	weblearning.com
WEBLICATIONS	weblications.com
WEBLIFT	weblift.com
WEBLINC	weblinc.com
WEBLIVELY	weblively.com
WEBLOQ	webloq.com
WEBMANTICA	webmantica.com
WEBMARKETING123	webmarketing123.com
WEBMASH	webmash.com
WEBMATION	webmation.com
WEBMEADOW	webmeadow.com
WEBMEDIABRANDS	webmediabrands.com
WEBMEDLEY	webmedley.com
WEBMEDX	webmedx.com
WEBMETRO	webmetro.com
WEBMOBI	webmobi.com
WEBMOBLINK	webmoblink.com
WEBMONDRIAN	webmondrian.com
WEBMOSA	webmosa.com
WEBNAMETAGS	webnametags.com
WEBNOW1	webnow1.com
WEBOLUTIONS	webolutions.com
WEBONYX	webonyx.com
WEBOO	weboo.biz
WEBOPS	webops.com
WEBORIGINATION	weborigination.com
WEBPAGEFX	webpagefx.com
WEBPAGEJR	webpagejr.com
WEBPLUSGRAPHICS	webplusgraphics.com
WEBPOSITION	webposition.com
WEBPRESENTED	webpresented.com
WEBPRINTING	webprinting.org
WEBPROMOEXPERT	webpromoexpert.com
WEBPRPRO	webprpro.com
WEBQA	webqa.net
WEBQUEE	webquee.com
WEBRAND	webrand.com
WEBRANDING	webranding.org
WEBRANKING	webranking.com
WEBRB	webrb.com
WEBREPLY	webreply.com
WEBREVELATION	webrevelation.com
WEBROOT	webroot.com
WEBRUAT	webruat.com
WEBSCOPE	webscope.com
WEBSEDGE	websedge.com
WEBSENSE	websense.com
WEBSERVCONSULTING	webservconsulting.com
WEBSHACK360	webshack360.com
WEBSHARK360	webshark360.com
WEBSHINE	webshine.com
WEBSIGHTMASTER	websightmaster.com
WEBSIGNIA	websignia.net
WEBSITEBIZ	websitebiz.com
WEBSITEDESIGNERDIRECT	websitedesignerdirect.com
WEBSITEDZYN	websitedzyn.com
WEBSITEEXTREME	websiteextreme.com
WEBSKILLET	webskillet.com
WEBSMARTPARTNERS	websmartpartners.com
WEBSOLVERS	websolvers.com
WEBSPLANET	websplanet.com
WEBSQUICK	websquick.com
WEBSTARTS	webstarts.com
WEBSTAURANTSTORE	webstaurantstore.com
WEBSTIR	webstir.com
WEBSTOP	webstop.com
WEBSTUDIOUSA	webstudiousa.com
WEBSULTING	websulting.com
WEBSULTS	websults.com
WEBSYNC	websync.com
WEBTALK	webtalk.org
WEBTASKS	webtasks.com
WEBTEGO	webtego.com
WEBTENNIS	webtennis.net
WEBTHRIFTSTORE	webthriftstore.com
WEBTOMED	webtomed.com
WEBTOMIX	webtomix.com
WEBTOOLSET	webtoolset.com
WEBTOP-DESIGNS	webtop-designs.com
WEBTPA	webtpa.com
WEBTRACTION	webtraction.net
WEBTRAFFIC2GO	webtraffic2go.com
WEBTRENDS	webtrends.com
WEBTYE	webtye.com
WEBUCAST	webucast.com
WEBUCATOR	webucator.com
WEBUNLEASH	webunleash.com
WEBUTATION	webutation.com
WEBVECTOR	webvector.com
WEBVEGA	webvega.com
WEBVELOP	webvelop.com
WEBVISION	webvision.com
WEBVITAMINS	webvitamins.com
WEBWEJ	webwej.com
WEBWIZE	webwize.com
WEBWORKSONLINE	webworksonline.com
WEBWORLD2000	webworld2000.com
WEBWRITESERVICES	webwriteservices.com
WEBYOG	webyog.com
WEBZION	webzion.com
WECHEM	wechem.com
WECLOUD9	wecloud9.com
WECONNECTFASHION	weconnectfashion.com
WED101	wed101.com
WEDBUDDY	wedbuddy.com
WEDBUSH	wedbush.com
WEDDINGBEE	weddingbee.com
WEDDINGWIRE	weddingwire.com
WEDDZILLA	weddzilla.com
WEDEAL	wedeal.com
WEDIT	wedit.com
WEDPICS	wedpics.com
WEDU	wedu.com
WEDU	wedu.org
WEEARTH	weearth.com
WEEBEEAPPS	weebeeapps.com
WEEBLY	weebly.com
WEEDMAPS	weedmaps.com
WEEKENTURE	weekenture.com
WEEPLAY	weeplay.com
WEEU	weeu.com
WEEWORLD	weeworld.com
WEEZABI	weezabi.com
WEEZER	weezer.com
WEFEED	wefeed.org
WEFI	wefi.com
WEFTA	wefta.net
WEFUNDER	wefunder.com
WEG	weg.net
WEGENER	wegener.com
WEGMANS	wegmans.com
WEGOALL	wegoall.com
WEGOFAIR	wegofair.com
WEGOLOOK	wegolook.com
WEGORA	wegora.com
WEGOTGURU	wegotguru.com
WEGOTITFORCHEAPBEATS	wegotitforcheapbeats.com
WEHAA	wehaa.com
WEHELP247	wehelp247.com
WEICHERT	weichert.com
WEIDNERCA	weidnerca.com
WEIGH-TRONIX	weigh-tronix.com
WEIGHTWATCHERS	weightwatchers.com
WEIL	weil.com
WEINGARTEN	weingarten.com
WEINSTEINMURPHY	weinsteinmurphy.com
WEIRDESIGN	weirdesign.com
WEIRDSTUFF	weirdstuff.com
WEISSHOUSE	weisshouse.com
WEIU	weiu.net
WELCHMANPIERPOINT	welchmanpierpoint.com
WELCHS	welchs.com
WELCOME2SOLUTIONS	welcome2solutions.com
WELCOMETECH	welcometech.com
WELDCOA	weldcoa.com
WELDCRAFT	weldcraft.com
WELDFABULOUS	weldfabulous.com
WELDINGMART	weldingmart.com
WELDSTAR	weldstar.com
WELDY-LAMONT	weldy-lamont.com
WELIKEWATER	welikewater.com
WELLADVANTAGE	welladvantage.com
WELLAND	welland.com
WELLBEATS	wellbeats.com
WELLBRIDGE	wellbridge.com
WELLCALL	wellcall.com
WELLCARE	wellcare.com
WELLCITY	wellcity.com
WELLCLICKS	wellclicks.com
WELLCORPRX	wellcorprx.com
WELLDOG	welldog.com
WELLDYNE	welldyne.com
WELLERO	wellero.com
WILDISH	wildish.com
WILDPACKETS	wildpackets.com
WILDTANGENT	wildtangent.com
WILDTRACKS	wildtracks.net
WILEY	wiley.com
WILEYWILSON	wileywilson.com
WILHELMINA	wilhelmina.com
WILKHAHN	wilkhahn.com
WILKSTONE	wilkstone.com
WILLBROS	willbros.com
WILLCARE	willcare.com
WILLCO	willco.net
WILLCOR	willcor.com
WILLDAN	willdan.com
WILLIAMS	williams.com
WILLIAMSMULLEN	williamsmullen.com
WILLIAMSTISON	williamstison.com
WILLIAMSWORKS	williamsworks.com
WILLIS	willis.com
WILLISKLEIN	willisklein.com
WILLOWRISE	willowrise.com
WILLOWTEC	willowtec.com
WILMERHALE	wilmerhale.com
WILMORITE	wilmorite.com
WILOCITY	wilocity.com
WILSDOM	wilsdom.com
WILSONART	wilsonart.com
WILSONHCG	wilsonhcg.com
WILSONMILLER	wilsonmiller.com
WILSONWEST	wilsonwest.com
WILSURE	wilsure.com
WILX	wilx.com
WIMACTEL	wimactel.com
WIMAXSATX	wimaxsatx.com
WIMBA	wimba.com
WIMCO	wimco.com
WIMOKU	wimoku.com
WIN-CON	win-con.com
WINALITE	winalite.com
WINANSTECH	winanstech.com
WINBOUND	winbound.com
WINBROOK	winbrook.com
WINBUYER	winbuyer.com
WINCARE	wincare.com
WINCENTRAL	wincentral.org
WINCEYCO	winceyco.com
WINCOMMUNICATIONS	wincommunications.com
WINCONOMY	winconomy.com
WINCUP	wincup.com
WIND2SHARE	wind2share.com
WINDERMERE	windermere.com
WINDES	windes.com
WINDHAWK	windhawk.com
WINDLAB	windlab.com
WINDOTRADER	windotrader.com
WINDOVER	windover.com
WINDOWSEP	windowsep.com
WINDOWSWEAR	windowswear.com
WINDPATH	windpath.com
WINDSORVII	windsorvii.com
WINDSWEPTACRE	windsweptacre.com
WINDURANCE	windurance.com
WINEACCESS	wineaccess.com
WINEBANK	winebank.com
WINEBOW	winebow.com
WINECONSUMER	wineconsumer.com
WINEDIRECT	winedirect.com
WINEFLITE	wineflite.com
WINELUXURY	wineluxury.com
WINEPOYNT	winepoynt.com
WINEQUEST	winequest.com
WINERYCRITIC	winerycritic.com
WINESOX	winesox.com
WINESPOKE	winespoke.com
WINESTARS	winestars.com
WINESTYR	winestyr.com
WINETALK	winetalk.org
WINETAMER	winetamer.com
WINETOMATCH	winetomatch.com
WINEWAVE	winewave.com
WINFERNO	winferno.com
WINFERTILITY	winfertility.com
WINFOREVER	winforever.com
WINFOSOFT	winfosoft.com
WINGDIPPER	wingdipper.com
WINGDOW	wingdow.com
WINGOZ	wingoz.net
WINGSPLAY	wingsplay.com
WINGSWEPT	wingswept.com
WINGTIP	wingtip.com
WINGWARRIOR	wingwarrior.com
WINIGENT	winigent.com
WINKSOUND	winksound.com
WINMAGIC	winmagic.com
WINNCOMM	winncomm.net
WINNERCOMM	winnercomm.com
WINNOL	winnol.com
WINNOV	winnov.com
WINNWEBTECHNOLOGY	winnwebtechnology.com
WINOVINO	winovino.com
WINPAK	winpak.com
WINPARK	winpark.com
WINSCRIBE	winscribe.com
WINSHIPPHILLIPS	winshipphillips.com
WINSHUTTLE	winshuttle.com
WINSPER	winsper.com
WINSTAFFING	winstaffing.com
WINSTEAD	winstead.com
WINSTEADPERRY	winsteadperry.com
WINSTED	winsted.com
WINTERCORP	wintercorp.com
WINTERGLAS	winterglas.com
WINTERGREENMARKETING	wintergreenmarketing.com
WINTERKIDS	winterkids.org
WINTERLOGIC	winterlogic.com
WINTERPROOF	winterproof.biz
WINTERWYMAN	winterwyman.com
WINTHROP	winthrop.edu
WINTHROP	winthrop.org
WINTHROPMORGAN	winthropmorgan.com
WINTRUST	wintrust.com
WINVALE	winvale.com
WINVIAN	winvian.com
WINWHOLESALE	winwholesale.com
WINWINHOST	winwinhost.com
WINXNET	winxnet.com
WIOCC	wiocc.net
WIPFLI	wipfli.com
WIPP	wipp.org
WIPRO	wipro.com
WIRAKA	wiraka.com
WIRCO	wirco.com
WIRE2AIR	wire2air.com
WIRE2NETLLC	wire2netllc.com
WIREBUZZ	wirebuzz.com
WIRECAD	wirecad.com
WIRED	wired.com
WIRED2FISH	wired2fish.com
WIREDBARN	wiredbarn.com
WIREDCRAFT	wiredcraft.com
WIREDMEDIUM	wiredmedium.com
WIREDRIVE	wiredrive.com
WIREDTREE	wiredtree.com
WIREDVIEWS	wiredviews.com
WIREFLY	wirefly.com
WIREFRAME	wireframe.com
WIRELAWYER	wirelawyer.com
WIRELESSBOBS	wirelessbobs.com
WIRELESSCAR	wirelesscar.com
WIRELESSSTORE	wirelessstore.com
WIRELESSWERKS	wirelesswerks.com
WIREMASTERS	wiremasters.net
WIREOVER	wireover.com
WIRESIDE	wireside.com
WIRESOFT	wiresoft.com
WIRESTONE	wirestone.com
WIREVIBE	wirevibe.com
WIREWAX	wirewax.com
WIREWERKS	wirewerks.com
WIREXPRESS	wirexpress.com
WISCONSIN	wisconsin.gov
WISCONSINRX	wisconsinrx.com
WISD	wisd.org
WISDOMDANCE	wisdomdance.com
WISDOMGROUP	wisdomgroup.com
WISDOMTOOLS	wisdomtools.com
WISDOMTREE	wisdomtree.net
WISEBANYAN	wisebanyan.com
WISELIT	wiselit.com
WISEMEN	wisemen.net
WISENGINEERING	wisengineering.com
WISEPLACE	wiseplace.org
WISERG	wiserg.com
WISERI	wiseri.com
WISESTAFF	wisestaff.com
WISETAIL	wisetail.com
WISETEK	wisetek.net
WISEWERKS	wisewerks.com
WISHBERRY	wishberry.net
WISHESONTHEWAY	wishesontheway.com
WISHLIFE	wishlife.com
WISHOO	wishoo.com
WISHPETS	wishpets.com
WISHWOULD	wishwould.com
WISPER	wisper.com
WISPRY	wispry.com
WISTERIA	wisteria.com
WISTRON	wistron.com
WISUITE	wisuite.com
WITBE	witbe.net
WITC	witc.edu
WITCO	witco.net
WITF	witf.org
WITFORD	witford.com
WITHERSPOON	witherspoon.com
WITHIN3	within3.com
WITHINGS	withings.com
WITHJOSH	withjosh.com
WITNESS	witness.org
WITNESSLA	witnessla.com
WITSA	witsa.org
WITTLEBEE	wittlebee.com
WITTWORLD	wittworld.com
WITTYPARROT	wittyparrot.com
WIUX	wiux.org
WIVALLEY	wivalley.net
WIX	wix.com
WIXON	wixon.com
WIYGUL	wiygul.com
WIZBE	wizbe.com
WIZBOTS	wizbots.com
WIZBRAIN	wizbrain.com
WIZEGUIDES	wizeguides.net
WIZEHIVE	wizehive.com
WIZELINE	wizeline.com
WIZLER	wizler.com
WIZNUCLEUS	wiznucleus.com
WIZPERT	wizpert.com
WIZSTREET	wizstreet.com
WJCS	wjcs.com
WJCT	wjct.org
WJE	wje.com
WJHW	wjhw.com
WJIE	wjie.org
WJXT	wjxt.com
WJZ	wjz.com
WJZD	wjzd.com
WK	wk.com
WKDU	wkdu.org
WKEP	wkep.com
WKMG	wkmg.com
WKRN	wkrn.com
WKSIEGER	wksieger.com
WKU	wku.edu
WKYC	wkyc.com
WLAJ	wlaj.com
WLBT	wlbt.net
WLC	wlc.edu
WLCAC	wlcac.org
WLNS	wlns.com
WLOX	wlox.com
WLPLASTICS	wlplastics.com
WLRK	wlrk.com
WM-CREATIVE	wm-creative.com
WMA	wma.org
WMAKER	wmaker.net
WMATA	wmata.com
WMBD	wmbd.com
WMCCANN	wmccann.com
WMEP	wmep.org
WMFD	wmfd.com
WMFE	wmfe.org
WMFO	wmfo.org
WMG	wmg.com
WMHT	wmht.org
WMI	wmi.com
WMNF	wmnf.org
WMO	wmo.int
WMRKMEDIA	wmrkmedia.com
WMS	wms.com
WMU	wmu.com
WMU	wmu.org
WMUZ	wmuz.com
WNA	wna.biz
WNCHC	wnchc.com
WNDAR	wndar.com
WNDIRECT	wndirect.com
WNIT	wnit.org
WNKY	wnky.net
WNNONLINE	wnnonline.com
WNTD	wntd.net
WNYLC	wnylc.com
WNYSKYDIVING	wnyskydiving.com
WNYT	wnyt.com
WOAMTEC	woamtec.com
WOAPE	woape.com
WOBOE	woboe.org
WOCCU	woccu.org
WOCHIT	wochit.com
WOCKHARDT	wockhardt.com
WOGL	wogl.org
WOHA	woha.com
WOKCHOW	wokchow.com
WOKEUPDEAD	wokeupdead.com
WOLBERWORKS	wolberworks.com
WOLF-GORDON	wolf-gordon.com
WOLFBLOCK	wolfblock.com
WOLFBROWN	wolfbrown.com
WOLFESBMC	wolfesbmc.com
WOLFMEDIA	wolfmedia.com
WOLFPK	wolfpk.com
WOLKINCURRAN	wolkincurran.com
WOLLA	wolla.com
WOLLZELLE	wollzelle.com
WOLSELEY	wolseley.com
WOLTCOM	woltcom.com
WOLTERSKLUWER	wolterskluwer.com